mẹ cô ấy	cô ấy mẹ
mẹ của cô ấy	mẹ cô ấy
quyển sách này	quyển sách này
ba giáo_viên	giáo_viên 3
nho xanh	nho xanh
không ăn	ăn không
thích ăn	ăn thích
giáo_viên thích nho	giáo_viên nho thích
giáo_viên thích những quả nho xanh	giáo_viên nho xanh thích
giáo_viên ăn quả cóc xanh	giáo_viên cóc xanh ăn
giáo_viên ăn quả chuối xanh	giáo_viên chuối xanh ăn
ai thích nho	nho thích ai
bao_nhiêu giáo_viên thích nho	nho thích giáo_viên bao_nhiêu
giáo_viên thích gì	giáo_viên thích gì
giáo_viên thích bao_nhiêu loại nho	giáo_viên loại nho thích bao_nhiêu
giáo_viên đã ăn mấy quả nho	giáo_viên nho ăn mấy
bạn ăn sáng lúc mấy giờ	bạn ăn sáng giờ mấy
tôi ăn sáng lúc 6 giờ	tôi sáng ăn giờ 6
em_gái tôi ít khi thăm_viếng họ_hàng	em_gái tôi họ_hàng thăm_viếng ít
dưa_hấu và chuối có cách ăn khác_nhau	dưa_hấu chuối ăn khác_nhau
tôi thương mẹ nhất	tôi mẹ thương nhất
khi có nhiều mây đen thì sẽ có lũ_lụt	khi mây đen nhiều thì lũ_lụt có
khi trời mưa tạnh thì sẽ có cầu vòng	khi mưa tạnh cầu vòng có
anh tôi đánh ông bình	anh tôi Bình đánh
ông bình bị anh tôi đánh	anh tôi Bình đánh
cuốn sách đặt trên tập nhạc	tập nhạc cuốn sách trên
ra lấy áo_quần vào đi con	ra áo_quần lấy
con đã cất áo_quần vào chưa	con áo_quần cất chưa
sắp mưa rồi đấy	mưa sắp
tập nhạc đặt dưới cuốn sách	cuốn sách tập nhạc dưới
trời sắp mưa đến_nơi rồi kìa	mưa sắp
Lan ơi , mưa	Lan mưa
mày có ra lấy áo_quần vào không Lan	Lan ra áo_quần lấy
Mưa ướt hết bây_giờ	mưa ướt hết
con phải cất áo_quần vào kẻo mưa đến_nơi rồi đấy	con áo_quần cất mưa
nước sôi rồi	nước sôi rồi
trong phích có nước sôi đấy	phích nước sôi có
tôi rót nước sôi vào phích	tôi phích nước sôi rót
ông nói gà , bà nói vịt	gà ông nói vịt bà nói
ông thì nói gà , bà thì nói vịt	gà ông nói vịt bà nói
ông nói gà thì bà nói vịt	gà ông nói thì vịt bà nói
ông mà nói gà thì bà lại nói vịt	gà ông nói thì vịt bà nói
giờ ngủ thì các cháu im_lặng	giờ ngủ cháu im_lặng
ông ngủ thì các cháu nên im_lặng	ông ngủ cháu im_lặng
sách hay thì ai cũng thích đọc	sách hay ai đọc thích
sách hay người_ta mới thích đọc	sách hay người_ta đọc thích
sách mà hay thì ai cũng thích đọc	sách hay thì ai đọc thích
sách có hay thì người_ta mới thích đọc	sách hay có người_ta đọc thích
mẹ đi Hà_Nội rồi	mẹ Hà_Nội rồi
năm nay mưa ít quá	mưa năm nay ít
bức này màu không đẹp	bức này màu đẹp không
trời mà mưa thì ở lại	mưa thì ở lại
mẹ đi Hà_Nội chưa	mẹ Hà_Nội đi chưa
Năm nay mưa nhiều không	mưa năm nay nhiều
bức này thế_nào	bức này thế_nào
trời mà mưa thì_sao	mưa thì_sao
tôi đau quá	đau quá
anh đau lắm à	anh đau
ở đây có muỗi	ở đây muỗi có
bây_giờ là ba giờ rồi	bây_giờ giờ 3
cái này bao_nhiêu tiền	cái này tiền bao_nhiêu
cuốn sách ấy đọc được đấy	cuốn sách ấy đọc được
con mèo này không đẹp	con mèo này đẹp không
anh thì cần gì đến tôi	tôi anh cần gì
cụ Tú tóc đã bạc hết rồi	Tú tóc bạc hết rồi
vườn nhà tôi lá rụng nhiều	lá vườn nhà tôi rụng nhiều
có một người thì làm không xuể	người một làm xuể không
bây_giờ chưa muộn đâu	bây_giờ muộn chưa
tham thì thâm	tham thâm thì
bao_giờ trời nổi can_qua	trời nổi can_qua
con vua thất_thế lại đi quét chùa	vua con thất_thế chùa quét
hòn đất mà biết nói_năng thì thầy_địa_lý hàm_răng không còn	đất nói_năng biết thầy_địa_lý hàm_răng còn không
con Cún người_ta bắt mất rồi	cún người_ta bắt rồi
cây gạo đầu làng bị sét đánh_đổi rồi	đầu làng cây gạo sét đánh_đổ
còn con Cún đâu rồi	Cún đâu
con Cún thì người_ta bắt mất rồi	Cún người_ta bắt rồi
ai làm được_việc này	việc này làm được ai
tôi làm được	tôi được làm
nó chịu rồi , còn anh thì_có làm được không ạ	nó chịu rồi anh làm được
tôi thì làm được	tôi làm được
con tôi đứa thì đi làm , đứa thì đi học	con tôi đứa làm đứa học
món này ăn thì ngon nhưng làm thì mất_công	món này ngon nhưng làm mất_công
việc này không chóng thì chầy cũng sẽ đưa đến kết_quả xấu	việc này không chóng thì chầy kết_quả xấu
anh_em ở đây không_ít_thì_nhiều đều có đóng_góp	anh_em ở đây không_ít_thì_nhiều đóng_góp có
hình_như anh hài_lòng lắm thì_phải	hình_như anh hài_lòng
anh Nam làm_việc thì chăm_chỉ	Nam làm_việc chăm_chỉ
anh Nam làm_việc chăm_chỉ	Nam làm_việc chăm_chỉ
anh mời thì tôi đến	anh mời tôi đến
anh mời tôi đến	anh mời tôi đến
thấy địch thì khai_triển đội_hình	địch thấy thì đội_hình khai_triển
thấy địch khai_triển đội_hình	địch thấy đội_hình khai_triển
khi tàu chạy thì về	tàu chạy thì về
khi tàu chạy về	khi tàu về
không làm , không ăn	làm không ăn không
không làm thì không ăn	làm không thì ăn không
cần gì , nói ngay đi	cần nói
cần gì thì nói ngay đi	cần thì nói
Không làm thì không ăn đấy nhé	làm không thì ăn không
cần gì thì nói ngay đi , thưa bẩm mãi	cần gì thì nói bẩm mãi
cần gì ? nói ngay đi	cần gì ? nói
chó treo , mèo đậy	chó treo mèo đậy
mềm nắn , rắn buông	mềm nắn rắn vuông
cá cả , lợn lớn	cá cả lợn lớn
trên thuận dưới hòa	trên thuận dưới hòa
trong thì ấm , ngoài thì êm	trong ấm ngoài êm
bói thì_ra ma , quét nhà thì_ra rác	bói thì_ra nhà quét rác thì_ra
trong có ấm thì ngoài mới có êm	trong ấm thì ngoài êm
bói mà ra ma thì quét nhà ra rác	bói ma ra thì nhà quét rác
trời thì mưa lâm_thâm	mưa lâm_thâm
làm_sao cho khỏi ướt	ướt làm_sao
mọi người đi trước cả rồi , còn tôi thì tôi sẽ đi_sau	mọi người đi rồi , tôi đi_sau sẽ
ai chứ , anh Ba thì khỏi phải giới_thiệu	giới_thiệu Ba phải khỏi
nó thì nó chẳng tin được đâu	nó tin chẳng
nó thì chẳng tin được đâu	nó tin chẳng
thì_giờ là vàng_bạc	thì_giờ vàng_bạc
Hà_Nội thủ_đô nước ta	Hà_Nội thủ_đô nước ta
người là hoa đất	người hoa đất
nó chê cấm là nó ốm đấy	nó cấm chê nó ốm đấy
được tặng giải 1 một cậu_bé mười_hai tuổi	giải 1 cậu_bé mười_hai tuổi
trên cùng là tượng phật	trên cùng tượng phật
em tôi thích nhất kẹo chanh	em tôi kẹo chanh thích
họ gặp nhau lần cuối là trong chiến_dịch Tây_Bắc	họ lần cuối gặp trong chiến_dịch Tây_Bắc
kỉ_niệm thành_lập đơn_vị ta là ngày 21 tháng mười_hai	thành_lập đơn_vị kỉ_niệm ngày 21 tháng mười_hai
anh_ấy đến đây để gặp chị	anh_ấy đến đây chị gặp
tai_nạn xảy_ra là vì người lái_xe say rượu	xảy_ra tai_nạn vì người lái_xe rượu say
nói hỗn với mẹ là không được	hỗn mẹ được không
anh chỉ phải đợi ba_tháng nữa_là cùng	anh đợi ba_tháng
anh thích nhất kẹo chanh	anh kẹo chanh thích nhất
em anh thích nhất cái gì	em anh thích nhất cái gì
em anh thích nhất kẹo gì	em anh thích nhất kẹo gì
em ai thích nhất kẹo chanh	kẹo chanh thích nhất em ai
anh tệ lắm	anh tệ lắm
anh là tệ lắm	anh tệ lắm
tôi chỉ thích đọc Nam_Cao	tôi Nam_Cao đọc thích
mẹ nó đánh là đánh cho nó sợ thôi	mẹ nó đánh là đánh cho nó sợ
nó yêu là yeu cáu túi_tiền của mày	nó yêu là yêu túi_tiền của mày
cô ta đẹp là đẹp vì lụa	cô ta đẹp đẹp vì lụa
họ gặp nhau lần cuối là ở Tây_Bắc cơ	lần cuối họ gặp là ở Tây_Bắc
họ gặp nhau lần cuối là ở Tây_Bắc chứ	lần cuối họ gặp là ở Tây_Bắc
họ gặp nhau lần cuối là ở Tây_Bắc mà , nói rồi , khổ lắm , hỏi mãi , cãi mãi	lần cuối họ gặp là ở Tây_Bắc nói rồi khổ lắm hỏi mãi cãi mãi
là tôi phỏng_đoán thế	tôi phỏng_đoán
còn cháu là	còn cháu là
thế_thì tốt	thế_thì tốt
thế_là tốt	thế_là tốt
nếu thế_thì tốt	nếu thế_thì tốt
nếu thế_là tốt	nếu thế_là tốt
có lệnh thì đi	lệnh có đi
có lệnh là đi	lệnh có đi
người mà đến thế thì_thôi	người đến thì_thôi
bây_giờ mà đi bộ thì không kịp	bây_giờ đi bộ không kịp
chỗ này mà xây_dựng một bệnh_viện thì tốt	chỗ này bệnh_viện xây_dựng tốt
cá này mà hấp với nấm thì ngon tuyệt	cá này nấm hấp ngon
là lớp trưởng mà không gương_mẫu thì_sao nói được các bạn	lớp trưởng gương_mẫu không nói các bạn được
đi thi mà chủ_quan thì rất dễ trượt	thi chủ_quan trượt dễ
người khó_tính	
người mà khó_tính thì chẳng ai ưa	người khó_tính ưa chẳng
cá_quả nấu với khế	cá_quả khế nấu
cá_quả mà nấu với khế thì rất ngon	cá_quả khế nấu ngon
non thì nhớ nước , nước mà quên non	non nước nhớ nước non quên
bài_toán này mà em không làm được sao	bài_toán này em làm được không
quá trưa mà khách vẫn chưa đến	trưa khách đến chưa
giữa làng giữa chợ mà hắn dám chửi cả bố_con nhà bá Kiến	giữa làng giữa chợ hắn bố_con Bá_Kiến chửi
hắn mà dám thế à	hắn dám
sáng nay , nó đến mà tôi lại không có nhà	sáng nay nó đến tôi nhà có không
trời lạnh mà ăn_mặc phong_phanh thì bị cảm đấy , mặc áo_ấm vào	trời lạnh ăn_mặc phong_phanh cảm áo_ấm mặc
trời lạnh mà ăn_mặc phong_phanh thế_này thì chưa bị cảm là may đấy	trời lạnh ăn_mặc phong_phanh cảm chưa may
nó làm được thế_này đã là khá lắm rồi	nó làm được thế_này khá rồi
đi_sau chót chắc là cơ_quan ta	đi_sau cơ_quan ta chắc chót
cái đó chỉ là liều thuốc an_thần thôi	thuốc an_thần thôi
ai làm nấy chịu	ai làm nấy chịu
muốn gì được nấy	muốn gì được nấy
cha nào con nấy	cha nào con nấy
bảo sao nghe vậy	bảo sao nghe vậy
dặn thế_nào thì làm thế_ấy	dặn thế_nào làm thế_ấy
bao_giờ đỗ trạng bấy_giờ cưới nhau	bao_giờ đỗ trạng bấy_giờ cưới
ai làm thì tôi không biết	ai làm tôi biết không
muốn gì thì đã được rồi	muốn gì thì được rồi
bao_giờ đỗ trạng thì cưới	bao_giờ đỗ trạng thì cưới
ai làm cũng được	làm ai cũng được
nó làm_gì cũng giỏi	nó làm_gì cũng giỏi
cha nào cũng mong con ngoan	cha nào mong con ngoan
anh nói sao cũng được	anh nói sao được
dặn thế_nào nó cũng quên	dặn thế_nào nó quên
cần bao_nhiêu cũng có	cần bao_nhiêu cũng có
bao_giờ đỗ trạng cũng được vinh_quy	bao_giờ đỗ trạng vinh_quy được
con có khóc thì mẹ mới cho bú	con khóc mẹ bú cho
tôi chưa kịp chuẩn_bị thì nó đã đến	tôi chuẩn_bị chưa nó đến
mới nứt mặt ra mà đã đòi lấy vợ	mặt nứt mới mà vợ lấy đòi
càng âu duyên mới , càng dào tình xưa	càng âu duyên mới càng dào tình xưa
mỗi người một vẻ	mỗi người một vẻ
chẳng thơm cũng thể hoa nhài	thơm chẳng cũng thể hoa nhài
nói đoạn , Ngũ_Viên liền đăm cổ tự_sát	đoạn nói Ngũ_Viên đăm cổ tự_sát
phen này , ông Tư ắt_là hả_hê	phen này Tư hả_hê
đó là một bài báo cực_kì bổ_ích	đó bài báo bổ_ích
nếu có giấy_mời thì anh hãy đi	nếu giấy_mời có anh đi hãy
anh Nam ấy à , tôi vừa gặp anh_ấy ở trường xong	Nam tôi gặp ở trường
công_việc ư , thì tôi vẫn quan_tâm đấy chứ	công_việc thì tôi vẫn quan_tâm
qua kinh_nghiệm cho ta thấy , tầm quan_trọng của việc quản_lí vật_tư	kinh_nghiệm thấy quản_lí vật_tư tầm quan_trọng
trong tình_hình đó đòi_hỏi ta phải cố_gắng	trong tình_hình đó đòi_hỏi ta cố_gắng phải
đau_đớn thay phận đàn_bà	đau_đớn thay phận đàn_bà
còn đâu những đêm vàng bên bờ suối	đêm vàng bên suối còn đâu
chẳng_qua là cái nợ_đời chi đây	chẳng_qua nợ_đời chi đây
lạ thay sức_mạnh của tâm_hồn	sức_mạnh tâm_hồn lạ thay
vui sao buổi hành_quân nắng lửa	buổi hành_quân nắng lửa vui
bỗng gặp người , lưng ngựa đèo cao	người gặp bỗng ngựa lưng đèo cao
no gì mà no	no gì mà no
đẹp gì con ấy mà đẹp	con ấy đẹp gì mà đẹp
nó có làm đâu mà làm	nó làm có đâu mà làm
bảo là no thì tôi có no gì đâu	bảo no tôi có no gì đâu
bảo là đẹp thì con ấy đẹp gì	bảo đẹp con ấy đẹp gì
nói là làm mà nó có làm đâu	nói làm nó có làm đâu
cái quyển sách mua hôm_qua ấy mà , anh đọc xong chưa	hôm_qua sách mua anh đọc xong chưa
Chí_Phèo nhận đi ngay	Chí_Phèo đi nhận ngay
hắn tức_khắc đến nhà đội Tảo	hắn nhà đội Tảo đến
anh này lại say_khướt rồi	anh này say_khướt rồi
bấy_giờ là vào mùa mưa	bấy_giờ mùa mưa
ở đây chúng_ta làm_việc 5 ngày 1 tuần	ở đây chúng_ta làm_việc tuần 1 ngày 5
làm_ăn như_thế thfi không là may rồi	làm_ăn như_thế thì may không
ai làm_việc này	làm_việc này ai
đứa nào đánh vỡ bình hoa	đánh vỡ bình hoa đứa nào
bao_giờ anh về	anh về bao_giờ
còn thế_nào nữa mới bằng_lòng	còn thế_nào bằng_lòng
người chiến_sĩ ấy , ai đã gặp anh không_thể_nào quên	chiến_sĩ ấy gặp ai anh quên không_thể_nào
những người đã được gặp Hồ_Chủ_Tịch	Hồ_Chủ_Tịch những người gặp được
những_ai đã gặp anh	anh những_ai đã gặp
những gì ta mong_muốn	những gì ta mong_muốn
nước_non mình đâu cũng đẹp như tranh	nước_non đẹp như tranh
hổ là một loài thú ăn thịt	hổ thú ăn thịt
nghèo không phải là tội_lỗi	nghèo tội_lỗi không phải
yêu là chết ở trong lòng một_ít	yêu trong lòng chết một_ít
chạy làm cho khí_huyết lưu_thông	chạy làm cho khí_huyết lưu_thông
một người thì chả mến	một người thì mến chả
một người như anh thì ai chả mến	một người như anh thì ai mến chả
lạt buộc chặt	lạt buộc chặt
loài thú ăn thịt là hổ	thú ăn thịt là hổ
loài thú ăn thịt điển_hình là hổ	thú điển_hình thịt ăn là hổ
loài thú ăn thịt cỡ lớn lông màu vàng có vằn đen là hổ	thú lớn lông màu vàng vằn đen thịt ăn là hổ
loài thú ăn thịt khó săn là hổ	thú thịt ăn săn khó là hổ
nó thích là kẹo chanh	kẹo chanh nó thích
hai người gặp nhau ở Yên_Bái	ở Yên_Bái hai người gặp
hai người gặp nhau lần cuối_cùng là ở Yên_Bái	ở Yên_Bái hai người lần cuối_cùng gặp
anh_ấy cần thì tôi làm xong ngay	anh_ấy cần thì tôi làm xong ngay
nếu anh thấy cần thì tôi làm xong ngay	nếu anh cần thì tôi làm xong ngay
khi mẹ lên tàu , các con đánh điện cho ba	khi mẹ tàu lên con ba đánh điện
thuở trời_đất nổi cơn gió_bụi	thuở trời_đất cơn gió_bụi nổi
khách má_hồng nhiều nỗi truân_chuyên	khách má_hồng nỗi truân_chuyên
lúc bà trở_dạ , dông_bão nỗi lên ầm_ầm	lúc bà trở_dạ dông_bão ầm_ầm
người nách thước , kẻ tay đao	người thước nách kẻ đao tay
khi chén rượu , khi cuộc cờ	khi chén rượu khi cờ
khi xem hoa nở , khi chờ trăng lên	khi hoa nở xem khi trăng lên chờ
đứa bảo có , đứa bảo không , biết nghe đứa nào bây_giờ	đứa bảo có đứa bảo không nghe đứa nào
ai chứ tôi thì tôi không biết	ai chứ tôi không biết
ở đâu chứ ở đây thì khỏi lo	ở đâu chứ ở đây lo khỏi
gì chứ cơm ngày hai bữa thì vẫn có	gì chứ cơm hai bữa có
ai chứ vợ thì_phải nịnh chứ	ai chứ nịnh vợ chứ
thế_nào chứ con_trâu đi trước cái cày đi_sau thì chưa phải là chủ_nghĩa	thế_nào chứ con_trâu trước đi cày đi_sau thì chủ_nghĩa chưa phải
suốt hai ngày đi bộ	hai ngày đi bộ
vào một buổi chiều hè , Ánh ra sông	vào một chiều hè Ánh sông ra
tuy mới học lớp 6 , Thúy đã làm được Toán lớp 7	tuy học lớp 6 mới Thúy Toán lớp 7 làm được
để nâng cao năng_suất , ta phải cải_tiến thao_tác	nâng cao năng_suất để ta cải_tiến thao_tác phải
tay ôm chồng sách , Nam bước vào phòng	tay sách ôm Nam phòng bước vào
vì trời mưa , cháu không đi nhà_trẻ	vì mưa cháu nhà_trẻ đi không
hôm_qua và hôm_kia thì họ đi bộ	hôm_qua và hôm_kia họ bộ đi
chiều_hôm qua thì Ánh ra sông	chiều_hôm qua Ánh sông ra
đang học lớp 6 mà Thúy đã làm được Toán lớp 7	lớp 6 học đang mà Thúy Toán lớp 7 làm được
muốn nâng cao năng_suất thì ta phải cải_tiến thao_tác	nâng cao năng_suất muốn ta cải_tiến thao_tác phải
Tay ôm chồng sách thế kia thì bước làm_sao được	sách tay ôm thế kia bước làm_sao
trời mưa thì cháu không đi nhà_trẻ được	mưa nhà_trẻ cháu không đi
Thúy đã làm được Toán lớp 7 khi đang còn học lớp 6	khi học lớp 6 Thúy Toán lớp 7 làm được
ta phải cải_tiến thao_tác để nâng cao năng_suất	ta cải_tiến thao_tác phải để nâng cao năng_suất
cháu không đi nhà_trẻ được vì trời mưa	nhà_trẻ cháu đi không được vì mưa
bước làm_sao được khi tay ôm chông sách thế kia	bước làm_sao khi tay ôm sách thế kia
bước làm_sao được với chồng sách ôm trên tay thế kia	bước làm_sao với sách tay ôm thế kia
họ đi bộ hôm_qua và hôm_kia	hôm_qua hôm_kia họ đi bộ
Ánh ra sông chiều_hôm qua	chiều_hôm qua Ánh ra sông
bao_giờ thì anh về	anh về bao_giờ
anh về bao_giờ	anh về bao_giờ
ở đây tôi cũng làm_việc	tôi ở đây làm_việc
tôi cũng làm_việc ở đây	tôi làm_việc ở đây
vào ngày chủ_nhật tôi chỉ nghe nhạc	chủ_nhật tôi nhạc nghe
tôi chỉ nghe nhạc vào ngày chủ_nhật	chủ_nhật tôi nhạc nghe
giếng này nước trong	giếng này nước trong
anh_ấy tôi đã ra_sức chiều_chuộng	anh_ấy tôi ra_sức chiều_chuộng
nước giếng này trong	nước giếng này trong
tôi đã ra_sức chiều_chuộng anh_ấy	anh_ấy tôi ra_sức chiều_chuộng
giếng nước này trong mà_lại gần nhà	giếng này nước trong gần nhà
nước giềng này trong mà_lại gần nhà	nước giềng này trong gần nhà
anh_ấy tôi đã ra_sức chiều_chuộng mà vẫn kêu là mình bị bạc_đãi	anh_ấy tôi ra_sức chiều_chuộng mà mình bị bạc_đãi kêu
tôi đã ra_sức chiều_chuộng anh_ấy mà vẫn kêu là mình bi bạc_đãi	tôi anh_ấy ra_sức chiều_chuộng mà mình bi bạc_đãi kêu
mẹ đã về	mẹ đã về
cái bình vỡ mất rồi	bình vỡ rồi
anh_ấy rất buồn	anh_ấy buồn rất
gây ra chuyện này không phải là tôi	gây chuyện này tôi không phải
ngồi bên phải là anh tôi	bên phải tôi ngồi là anh
bệnh_nhân X đã mổ xong	bệnh_nhân X mổ xong
thuốc này uống ngày năm giọt	thuốc ngày uống giọt năm
nó ăn nhiều nhất_là kẹo chanh	nó kẹo chanh ăn nhiều
khi vui thì vỗ_tay vào	khi vui vỗ_tay
năm phút nữa bắt_đầu nhé	năm phút bắt_đầu
máy bay cât cánh là vào lúc 6 giờ	máy bay cât cánh giờ 6
giường này cháu bé nằm	cháu bé giường này nằm
ở đây thì không tiện	ở đây tiện không
chìa_khóa này không mở được cửa	chìa_khóa này cửa mở không được
nồi đồng nấu ốc	nồi đồng ốc nấu
tôi mở cái ổ_khóa này bằng mũi dao_nhíp	tôi ổ_khóa này mở bằng mũi dao_nhíp
nấu ếch thì_phải nồi đất	ếch nồi đất nấu
mây vàng thì gió , mây đỏ thì mưa	mây vàng gió mây đỏ mưa
ông ấy đến thì tôi đi	ông ấy đến tôi đi
dù ai nói ngã nói nghiêng thì ta vẫn vững như kiềng ba chân	dù nói ngã nói nghiêng ta như kiềng ba chân
Kasparov là vô_địch cờ_vua thế_giới giới năm 1988	Kasparov vô_địch cờ_vua thế_giới giới năm 1988
nhà_nước là tôi	nhà_nước tôi là
phê_bình không phải là mạt_sát	phê_bình không phải mạt_sát
mạt_sát không phải là phê_bình	mạt_sát không phải phê_bình
vàng gió , đỏ mưa	vàng gió đỏ mưa
mưa trắng , nắng đen	mưa trắng nắng đen
của đau , con xót	của đau con xót
Nam trúng_cử	Nam trúng_cử
Nam đã trúng_cử	Nam trúng_cử đã
Nam trúng_cử rồi	Nam trúng_cử rồi
Nam có_thể trúng_cử đấy	Nam trúng_cử có_thể
có_thể Nam sẽ trúng_cử	có_thể Nam trúng_cử sẽ
Nam có_thể sẽ trúng_cử	có_thể Nam trúng_cử sẽ
Nam chắc_chắn sẽ trúng_cử	Nam trúng_cử chắc_chắn
chắc_chắn là Nam sẽ trúng_cử	chắc_chắn Nam trúng_cử sẽ
Nam trúng_cử là cái chắc	Nam trúng_cử chắc
Nam thì tôi tin chắc là sẽ trúng_cử	tôi tin Nam trúng_cử chắc
Nam sẽ trúng_cử một_cách chắc_chắn	Nam trúng_cử chắc_chắn
theo ý tôi thì nên làm ngay	theo tôi nên làm ngay
lẽ_ra thì anh phải đến sớm hơn	lẽ_ra anh đến sớm hơn phải
nói_chung thì kết_quả cũng khả_quan	nói_chung kết_quả khả_quan
quả_tình là tôi có ý gì chê anh đâu	quả_tình tôi anh ý chê có
hiếm một nỗi là ông_bà ấy không có con_trai	hiếm ông_bà ấy con_trai không
trời hình_như muốn trở rét	trời rét muốn
đúng là anh này say rồi	đúng anh này say
tội này ít_nhất là ba năm tù	tội này tù ba năm ít_nhất
chẳng thà ông ấy cứ nói_toẹt ra	chẳng thà ông ấy nói_toẹt ra
đội ta e thua mất	đội ta thua mất
đoạn này tôi thấy không ổn	tôi đoạn này thấy không ổn
thiết_tưởng chuyện này anh thừa rõ	thiết_tưởng chuyện này anh rõ
may_mà ta đã dự_liệu trước cả rồi	may_mà ta dự_liệu trước rồi
hình_như anh sốt ruột	hình_như anh sốt ruột
nhỡ sẩy chân một cái thì khốn	nhỡ sẩy chân thì khốn
cái này giá chỉ năm ngàn thì nhiều	cái này giá chỉ năm ngàn
Nam sẽ trúng_cử mới chết chứ	Nam trúng_cử mới chết chứ
thôi_thì có phải bán cả con lẫn chó cũng đành	thôi_thì con chó bán phải đành
nó còn được thăng chức nữa không_biết_chừng	không_biết_chừng nó thăng chức nữa
nó suýt ngã	nó ngã suýt
cứ nói thế_thì nó khắc hiểu	cứ nói thế_thì nó khắc hiểu
mọi người phải có_mặt lúc 6 giờ	mọi người giờ 6 có_mặt
chỉ còn hai bát cơm trong nồi	hai bát cơm nồi chỉ còn
có những mười người vắng_mặt	có người mười vắng_mặt
gã kia làm hỏng cái máy mất	gã kia máy làm hỏng
nó cố_ý làm hỏng cái máy thật	nó máy làm hỏng cố_ý
Nam sẽ trúng_cử đó là một điều chắc_chắn	Nam trúng_cử là điều chắc_chắn
thế_mà quả thị , lạ thay , vẫn không rơi xuống	thế_mà quả thị rơi xuống không lạ
của_đáng_tội , nó có biết gì đâu	của_đáng_tội nó biết gì
luật này , như ai_nấy đều biết , có một phạm_vi hiệu luật rất hẹp	ai_nấy đều biết luật này phạm_vi hiệu luật hẹp
nó làm rách cái màn mất	nó cái màn làm rách
nó làm rách mất cái màn	nó cái màn làm rách
nó làm rách cái màn mất rồi	nó cái màn làm rách
vì không đọc kỹ đề , nó đã làm hỏng mất bài tập_làm_văn	đề đọc kỹ không nó tập_làm_văn hỏng
tớ sẽ được điểm 10 về môn toán một_cách chắc_chắn	tớ toán điểm 10 được
tôi chỉ tập_trung tư_tưởng được trong vòng một giờ đồng_hồ	tôi tư_tưởng tập_trung được một giờ
ông ấy làm_việc liên_tục suốt từ sáng đến chiều	ông ấy làm_việc sáng chiều liên_tục
nó làm hỏng bài tập_làm_văn vì không đọc kỹ đề_bài	nó tập_làm_văn làm hỏng vì đề_bài đọc không kỹ
suốt từ sáng đến chiều , ông ấy làm_việc liên_tục	sáng chiều ông ấy làm_việc liên_tục
chắc_chắn là tớ sẽ được điểm 10 về môn toán	tớ toán điểm 10 được chắc_chắn
nó hỏng kì thi này vì môn toán	nó toán thi hỏng
nó hỏng kì thi này vì dốt	nó thi hỏng vì dốt
nó hỏng kì thi này vì lạc_đề	nó thi hỏng vì lạc_đề
nó hỏng kì thi này vì đề thi khó quá	nó thi hỏng vì đề khó
em ơi buồn làm_chi	em buồn làm_chi
vần vấn_đề này thưa các bạn chúng_ta có rất nhiều ý_kiến	các bạn chúng_ta vấn_đề này ý_kiến nhiều có
cậu Vàng đi_đời rồi ông giáo ạ	ông giáo cậu Vàng đi_đời rồi
mà chàng quên chí cao vì sự_nghiệp	mà chàng sự_nghiệp chí cao vì
giời_ơi là giời , có chồng_con nhà nào như_thế không	giời_ơi giời có chồng_con nhà nào như_thế
sau trúc , ô_kìa	trúc sau ô_kìa
Xiêm_áo ai	Xiêm_áo ai
trời_đất ạ , có đời_nào như_vậy , cái thổ_tả gì cũng đắt	trời_đất có đời_nào như_vậy thổ_tả gì đắt cũng
vâng , mời bà cứ ngồi chơi thư_thả xơi nước , xơi trầu đã	mời bà ngồi chơi nước xơi trầu xơi
ô_hay , con làm_gì	ô_hay con làm_gì
vâng , tôi biết	vâng tôi biết
Tính ông Cửu nhà tôi nhân lão tâm bất lão	tính ông Cửu tôi nhân lão tâm bất lão
ô_hay , mẹ_con nó đi đâu cả rồi	ô_hay mẹ_con đâu
cô bé nhà bên ai_ngờ cũng là du_kích	cô bé nhà bên ai_ngờ là du_kích
ông Năm ấy mà , ông ấy tốt lắm	ông Năm tốt
điều ta không muốn thì không nên làm cho người khác	ta điều muốn không làm cho người khác nên không
bằng_lòng hay không thì cũng nói cho ngta biết	bằng_lòng hay không thì nói người_ta biết
dễ người dễ ta	dễ người dễ ta
	
lắm thầy rầy ma	thầy lắm ma rầy
	
	
xấu chàng khổ ai	chàng xấu khổ ai
ở đâu quen đấy	ở đâu quen đấy
mai mẹ về	mai mẹ về
ở đây bơi rất thích	ở đây bơi thích
bài này giải rất dễ	bài này giải dễ
mát thì ở đây mát hơn	mát thì ở đây mát hơn
cơm đã dọn xong	cơm dọn xong
người vẽ bức này là ông Đức	người bức này vẽ là Đức
lấy chồng hay_chữ là tiên	chồng hay_chữ lấy là tiên
năm_ngoái lạnh lắm	năm_ngoái lạnh
ở đây vui quá nhỉ	ở đây vui quá
có yêu thì nói rằng yêu	yêu thì nói yêu
gà trống , gà mái đều là gà sống cả	gà trống gà mái đều gà sống
về hay ở đều không tiện	về hay ở không tiện
họ sống và chiến_đấu	họ sống và chiến_đấu
dẫn_đầu đội_hình là cờ và biểu_ngữ	đội_hình dẫn_đầu cờ biểu_ngữ
muốn kịp thì mai đi máy_bay	kịp muốn thì mai máy_bay
ông_cụ dạo này yếu lắm	dạo này ông_cụ yếu lắm
ở đời quý nhất chữ_nhân	ở đời chữ_nhân quý
may_vá học cũng không dễ	may_vá học dễ không
nấu_nướng thì ở nhà có mình em	nấu_nướng nhà mình em có
thế_gian được vợ hỏng chồng	thế_gian vợ được chồng hỏng
lòng quê đi một bước_đường một đau	lòng quê đi một bước_đường một đau
mai đi thì muộn	mai đi muộn thì
ở đây mà làm hồ bơi thì tuyệt	ở đây hồ bơi làm tuyệt
bài này mà lạc_đề thì hỏng rồi	bài này lạc_đề thì hỏng
mát mà hơn đây thì chỉ có Sa_Pa	mát hơn đây có Sa_Pa
mai muốn kịp thì đi máy_bay	mai kịp muốn máy_bay
ông_cụ yếu đi thì đáng lo	ông_cụ yếu lo
đời còn quý chữ_nhân thì chưa đến_nỗi	đời chữ_nhân quý thì chưa đến_nỗi
may_vá có khó thì mới_phải học	may_vá khó thì mới_phải học
mình em nấy nướng thì không kịp	em ấy nướng không kịp
chưa nói đã cười là người vô_duyên	nói chưa cười đã người vô_duyên
Cao_Bằng gạo_trắng_nước_trong	Cao_Bằng gạo_trắng_nước_trong
ngọn đèn khi tỏ khi mờ	đèn khi tỏ khi mờ
món này ăn thì ngon làm thì tốn công	món này ngon ăn tốn công làm
ở đây trước lạ sau quen	ở đây lạ trước quen sau
lúc này gạo_châu_củi_quế	lúc này gạo_châu_củi_quế
làm cho thì thân_tàn_ma_dại	
ai về ai ở mặc ai	về ai ở ai mặc ai
trên thuận dưới hòa là hay nhất	trên thuận dưới hòa
trong đánh ra ngoài đánh vào thì nhất_định thắng	đánh trong ra ngoài đánh vào thì thắng nhất_định
ăn_có_nhai_nói_có_nghĩ thì mới là người khôn	ăn_có_nhai_nói_có_nghĩ là người khôn
khôn sống mống chết là một thực_tế xã_hội	khôn sống mống chết là xã_hội thực_tế
con_trâu đi trước cái cày theo sau thì còn lạc_hậu	con_trâu đi trước cày sau thì lạc_hậu còn
	
	
lỗi này tại ai thì tôi không biết	lỗi này tại ai tôi không biết
quan biết thì nó chết	quan biết nó chết
mai đã đi thì tôi chuẩn_bị không kịp	mai đi tôi chuẩn_bị không kịp
sen xa hồ sen khô hồ cạn	hồ sen xa hồ cạn
liễu xa đào liễu ngả đào nghiêng	liễu đào xa liễu ngả đào nghiêng
sớm mưa trưa nắng là anh yêu mình	mưa sớm nắng trưa là anh mình yêu
sông_cạn_đá_mòn anh vẫn thủy_chung	sông_cạn_đá_mòn anh thủy_chung vẫn
ai đi ai về nó cũng chẳng để_ý	đi ai về ai nó chẳng để_ý
sáng vác tối vác thì ai mà chả chán	vác sáng vác tối chán
đau quá	
đang bận lút đầu lút cổ	
đi đâu_đấy	đi đâu_đấy
khỏe chứ	
có đau không	đau có
cấm hút thuốc_lá	thuốc_lá hút cấm
không chạy xe trong sân	trong sân chạy xe không
coi_chừng mất xe	xe mất coi_chừng
phải tôn_trọng và giúp_đỡ người già_cả và phụ_nữ có_thai	tôn_trọng giúp_đỡ người già_cả phụ_nữ có_thai phải
cần ăn để mà sống chứ không phải sống để mà ăn	ăn sống cần chứ sống ăn không phải
ngồi xuống	
mời ngồi xuống	mời ngồi
quý_vị ngồi xuống đi	quý_vị ngồi
tôi mời quý_vị an_tọa	quý_vị an_tọa mời
cám_ơn các bạn	cám_ơn các bạn
cám_ơn các bác	cám_ơn các bác
khuya rồi	khuya rồi
nóng quá , sắp mưa rồi	nóng quá mưa sắp
như tranh_thủy_mặc ấy , đẹp quá	như tranh_thủy_mặc đẹp
nhiều bướm quá , có con đẹp quá kìa	bướm nhiều có con đẹp quá
tệ đến thế kia à	tệ thế
ở đây lúc này , trời nóng quá	ở đây lúc này nóng quá
ở đây lúc này , trời sắp mưa	ở đây lúc này mưa sắp
số tác_giả này nhận_định khác hẳn	tác_giả này nhận_định khác hẳn
đã bảo mà	bảo đã
	
một cái tát rất kêu	một tát rất kêu
tiếng đấm , tiếng đá nhau bình_bịch	đấm đá tiếng bình_bịch
họ đã bảo mà	họ bảo đã
phen này thì_phải biết	phen này thì_phải biết
lúc ấy có_thể nghe thấy một cái tác rất kêu	lúc ấy tát nghe
lúc ấy có_thể nghe thấy tiếng đấm_đá nhau bình_bịch	lúc ấy có_thể đấm_đá nghe bình_bịch
đấm_đá như_thế cứ gọi_là tan xương	đấm_đá như_thế tan xương
đại_bác ùng_oàng suốt đêm	đại_bác ùng_oàng suốt đêm
tiếng ùng_oàng của đại_bác nghe thưa dần	tiếng đại_bác ùng_oàng nghe thưa dần
có_tiếng đại_bác nổ ùng_oàng từ xa	xa có_tiếng đại_bác ùng_oàng
điều ấy tôi biết rồi	điều ấy tôi biết rồi
điều anh vừa nói ấy tôi biết rồi	điều anh vừa nói tôi biết
tôi đã xem trận ấy	tôi trận ấy đã xem
tôi đã xem đội ta đấu với đội bạn	tôi xem đội ta đội bạn đấu
vì lợi_ích chung ông_ta đã xin từ_chức	vì lợi_ích chung ông_ta từ_chức xin
Cụ Tú đã bạc hết cả tóc rồi	Cụ Tú tóc bạc hết
Cụ Tú tóc bạc hết cả rồi	Cụ Tú tóc bạc hết
ôi , cảnh ly_biệt mà_sao buồn vậy	ly_biệt mà_sao buồn
anh Đức này , anh lấy tôi làm vợ nhé	anh Đức anh tôi lấy làm vợ
ông Chưởng , phó của cha tôi , nay đã lên tướng	ông Chưởng phó cha tôi nay lên tướng
anh có biết ông ấy không , ông Văn ấy mà	anh ông ấy biết Văn
không ai nói_gì , mọi người lảng dần ra	ai nói_gì không mọi người lảng dần
không ai nói_gì , rồi mọi người lảng dần ra	ai nói_gì không mọi người lảng dần
không ai nói_gì nhưng mọi người lảng dần ra	ai nói_gì không nhưng mọi người lảng dần
không ai nói_gì nên mọi người lảng dần ra	ai nói_gì không nên mọi người lảng dần
tuy không ai nói_gì nhưng mọi người lãng dần ra	tuy ai nói_gì không nhưng mọi người lãng dần
vì không ai nói_gì nên mọi người lãng dần	vì ai nói_gì không nên mọi người lãng dần
đã bấy_lâu_nay bác tới nhà	đã bấy_lâu_nay bác tới nhà
trẻ thời đi vắng , chợ thời xa	trẻ thời đi vắng chợ thời xa
ao sâu nước cả , khôn chài cá	ao nước sâu khôn chài cá
vườn rộng rào thưa , khó duổi gà	vườn rộng rào thưa gà khó duổi
cải chửa ra cây , cà mới nụ	cải cây chửa ra cà nụ mới
bầu vừa rụng rốn , mướp ra hoa	bầu rốn rụng mướp hoa ra
đầu_trò tiếp khách trầu_không có	đầu_trò khách tiếp trầu_không có
bác đến chơi đây , ta với ta	bác đến chơi đây ta với ta
tôi cũng không biết	tôi không biết cũng
sao anh lại nói thế	anh nói sao
chuyện này nghiêm_trọng đây	chuyện này nghiêm_trọng
nhưng ai biết mà sợ	biết ai mà sợ
sau đây là vài điểm cần nói rõ thêm	sau đây vài điểm nói rõ cần
tôi không dính vào việc này	tôi dính không vào
anh cũng đừng nghi_ngờ gì anh_ấy	anh nghi_ngờ đừng anh_ấy
đừng ra sân , ngoài ấy rét lắm	sân ra đừng ngoài ấy rét
bà ấy đánh con chó dữ quá , làm như_thế không có tác_dụng giáo_dục	bà ấy chó đánh quá như_thế tác_dụng không có
tôi không muốn đi , vả_lại đã muộn rồi	tôi đi không muốn vả_lại muộn rồi
	
cám_ơn bác	
cháu cám_ơn bác	
cháu cám_ơn bác ạ	
cuốn Chí_Phèo ở dưới chồng tạp_chí	cuốn Chí_Phèo ở dưới tạp_chí
dưới chồng tạp_chí có cuốn Chí_Phèo	dưới tạp_chí có cuốn Chí_Phèo
chồng tạp_chí ở trên cuốn Chí_Phèo	tạp_chí trên cuốn Chí_Phèo
cái xe màu đỏ ấy mới là xe của tôi	xe màu đỏ là xe của tôi
xe của tôi là cái màu đỏ ấy	xe của tôi màu đỏ
ăn nhiều quá thì mới sinh_bệnh chứ	ăn nhiều sinh_bệnh
sinh_bệnh đâu phải tại ăn , mà tại ăn nhiều quá đấy chứ	sinh_bệnh đâu phải tại ăn nhiều
ai chứ nó thì không tin được	nó không tin
gà của ông Tư chết mất hai con	ông Tư gà hai chết
anh_ấy đã giết ông Ba	anh_ấy ông Ba giết
anh_ấy đã lấy tiền ông Ba	ông Ba anh_ấy lấy tiền
tôi không tiêu tiền_của ông Ba	tôi ông Ba tiêu tiền_của không
nó phải giải nhiều bài	nó nhiều bài phải giải
nó giải được năm bài , thì ba bài đúng	nó bài năm ba đúng
còn hai bài kia thì sai	còn hai sai
anh_ta biết đánh bóng_bàn	anh_ta bóng_bàn đánh biết
trong khoa còn có người khác biết đánh bóng_bàn	trong khoa người bóng_bàn đánh có
năng_lực chuyên_môn của anh_ta nói ra không tiện	nói anh_ta năng_lực chuyên_môn tiện không
nói vào_đề	nói vào_đề
nói hết	nói hết
nói vừa đủ	nói đủ vừa
nói rõ_ràng	nói rõ_ràng
từ xóm bên bốc lên một cột khối	xóm bên cột khối bốc lên
lá rụng trên thềm	trên thềm lá rụng
chìa_khóa này mở_cửa kho	chìa_khóa này kho mở_cửa
có muỗi	muỗi có
còn tiền trong túi	túi tiền còn
trên tường treo một bức tranh	bức tranh trên tường
con chó chạy ngoài sân	ngoài sân chó chạy
thằng bé nhìn con hổ	thằng bé hổ nhìn
Nam lau bàn	Nam bàn lau
Nam đóng bàn	Nam bàn đóng
Nam cho em bé cái kẹo	Nam em bé cho kẹo
Nam đập cái cốc vỡ tan	Nam cốc đập vỡ
Nam đánh cái chuông kêu boong_boong	Nam chuông đánh boong_boong
Nam sai em đi mua thuốc_lá	Nam em sai thuốc_lá mua
gió mở tung cửa_sổ	cửa_sổ gió mở
gió không nên mở tung cửa_sổ	cửa_sổ gió mở không nên
cháu bé gầy_yếu quá	bé gầy_yếu
chúng_tôi rất thương cháu	chúng_tôi cháu thương
chàng yêu nàng	
nó rất sợ rắn	rắn nó sợ
con tê_giác không khỏe bằng con voi	voi tê_giác khỏe không bằng
anh_ấy giỏi hơn	anh_ấy giỏi hơn
chương 1 là chương dài nhất của cuốn sách	chương 1 chương cuốn sách dài nhất
trung_úy Dũng là chỉ_huy đại_đội chúng_tôi	trung_úy Dũng đại_đội chúng_tôi chỉ_huy
đây là chỗ họp thích_hợp nhất	đây là chỗ họp thích_hợp nhất
chiếc xe khổ của vẫn mới hơn của tôi	xe anh mới hơn vẫn của tôi
chiều nay thế_nào cũng mưa	chiều nay mưa thế_nào cũng
sao anh nỡ làm thế	anh làm thế sao nỡ
tôi cần biết ngày anh lên_đường	ngày anh lên_đường tôi biết cần
lần sau còn thể nữa thì tôi không để cho anh yên đâu	lần sau anh tôi để không yên
tập truyện của anh là một kiệt_tác	truyện anh kiệt_tác
mọi người đứng_dậy	mọi người đứng_dậy
mọi người đứng_dậy đi	mọi người đứng_dậy
mọi người đứng_dậy ư	mọi người đứng_dậy
cảnh đẹp mà buồn	cảnh đẹp mà buồn
cảnh đẹp mà buồn làm_sao	cảnh đẹp mà buồn làm_sao
tôi cấm anh hút thuốc_lá	anh thuốc_lá hút tôi cấm
cha tôi cấm tôi hút thuốc_lá	tôi hút thuốc_lá cha cấm
tôi đã bõ thuốc_lá	tôi thuốc_lá bõ
tôi cấm anh	tôi anh cấm
tôi cấm đấy	tôi cấm
tôi đã cấm anh kia rồi mà	tôi anh cấm
tôi cấm nó rồi	tôi nó cấm
nó cấm anh à	nó anh cấm
đề_nghị các đồng_chí yên_lặng	đồng_chí đề_nghị yên_lặng
xin đề_nghị các đồng_chí yên_lặng	xin đồng_chí đề_nghị yên_lặng
tôi gửi các bạn lời chào thân_ái	tôi bạn gửi lời chào thân_ái
tôi xin gửi các bạn lời chào thân_ái	tôi bạn gửi lời chào thân_ái
	
tôi xin cảm_ơn	tôi cảm_ơn
các con không được cãi nhau nữa	con cãi nhau không được
anh kê cái bàn ấy ra đây cho đẹp	anh bàn kê đây đẹp
bác vào chơi xơi nước ạ	bác vào nước xơi
cái bông hoa này vẽ to quá	hoa này vẽ to
đường_sá lầy_lội kinh người	đường_sá lầy_lội kinh
chính anh làm hỏng việc chứ ai	anh làm hỏng
làm như_thế cũng được chứ sao	làm như_thế được chứ sao
lại muốn vòi tiền nữa chứ gì	muốn tiền chứ gì
anh phê_bình hay mạt_sát tôi đấy	anh tôi phê_bình mạt_sát
con hay con mèo đánh vỡ bình hoa	con hay con mèo bình hoa vỡ
cậu thích chó hơn hay mèo hơn	cậu chó mèo thích hơn
Nam tặng em bé kẹo hay nước_hoa	kẹo hay nước_hoa bé Nam tặng
mình đi xe_lửa hay máy_bay	xe_lửa hay máy_bay mình đi
cuộc họp hoãn lại một tuần hay nửa tháng	họp hoãn một tuần hay nửa tháng
ông có diêm không	ông diêm có
con muốn ăn đòn phải không	con đòn muốn
mày có câm cái mồm đi không	mày mồm câm
ông cho tôi xin tí lửa	ông lửa tôi xin
con hãy ngừng ngay cái việc đáng đánh_đòn ấy	ngừng ngay việc đáng đánh_đòn
mày câm cái mồm đi	mày mồm câm
bỏ xuống đây	bỏ xuống đây
ăn gì to_lớn đẫy_đà làm_sao	ăn gì to_lớn đẫy_đà làm_sao
thế_thì có khổ cho tôi không	thế_thì tôi khổ
người đâu mà vô_tâm	người đâu mà vô_tâm
tổ_quốc có bao_giờ đẹp thế_này chăng	tổ_quốc có bao_giờ đẹp thế_này chăng
nhằm thẳng quân_thù , bắn	nhằm quân_thù bắn
ngủ đi	
mây ơi , hãy ngừng trôi	mây trôi hãy ngừng
lá ơi , đừng rụng nữa	lá ơi rụng đừng
đừng xanh như lá , bạc như vôi	xanh như lá bạc như vôi đừng
hãy tươi mãi màu xanh_tươi ánh thép	màu xanh_tươi tươi mãi ánh thép hãy
xin các bạn giữ trật_tự	xin bạn trật_tự
các bạn giữ trật_tự	bạn trật_tự
các bạn có giữ trật_tự không nào	bạn trật_tự không
anh_ta có tài mà chẳng có đức	anh_ta tài có đức chẳng có
việc này khó lắm đấy	việc này khó lắm đấy
em ơi , buồn làm_chi	em buồn làm_chi
thế có khổ không	thế khổ có
những ngày tôi đang sống đáng sống bao_nhiêu	những ngày tôi sống đáng sống bao_nhiêu
đẹp quá nhỉ	đẹp quá
cuốn truyện này rất hay	cuốn truyện này hay
cuốn truyện này không hay	cuốn truyện này hay không
cuốn truyện này không hay lắm	cuốn truyện này hay không
thanh này không dài bằng thanh kia	thanh này thanh kia không dài bằng
thanh này ngắn hơn thanh kia	thanh này thanh kia ngắn hơn
rẻ thì_có rẻ , nhưng không đẹp	rẻ thì_có rẻ nhưng đẹp không
nó có giận anh thật , nhưng không ghét anh đâu	anh nó giận có nhưng ghét không
cháu đã làm bài thi toán	cháu bài thi toán làm đã
bài thi toán cháu được nửa điểm	bài thi toán cháu nửa điểm
vì_thế là nhiều đối_với cháu	vì_thế đối_với cháu nhiều
cháu kén quá đấy	cháu kén quá
còn bạc còn tiền còn đệ_tử	bạc còn tiền còn đệ_tử còn
Nam trêu em bé	bé Nam trêu
em bé khóc	bé khóc
gió đánh cành tre	cành tre gió đánh
gió thổi , mây bay	thổi gió bay mây
công_việc đang bộn_bề	công_việc bộn_bề
mọi lí_thuyết đều xám	lí_thuyết mọi xám đều
Nam là học_sinh giỏi	Nam học_sinh giỏi
đáng tiếc thật	thật tiếc
đèn đêm đã bật , sân_bay lại bắt_đầu làm_việc	đèn đêm bật sân_bay bắt_đầu làm_việc
vào đâu tre cũng sống , ở đâu tre cũng xanh tốt	vào đâu tre sống đâu tre xanh tốt
nước reo quanh chân lúa , lúa rung lên , lòng người cũng rung lên	nước quanh chân lúa reo lúa rung lòng người rung
ngoài đình , trống lại thúc , mõ lại khua , tù_và rúc liên_thanh bất chỉ	ngoài đình trống thúc mõ khua tù_và liên_thanh rúc
cằm ông bạnh ra , mắt ông trợn_trừng , cả người ông như một pho tượng bằng đồng_đen cuồn_cuộn những bắp_thịt	cằm ông bạnh ra mắt trợn_trừng cả người pho tượng bằng đồng_đen cuồn_cuộn bắp_thịt
những chiếc ô_tô chạy đi , chạy lại như những con_thoi , máy_bay_phản_lực rít ào_ào và len_lỏi giữa tất_cả những ô_tô , máy_bay ấy có một chiếc xe_đạp ba bánh	ô_tô chạy đi chạy như con_thoi máy_bay_phản_lực rít và len_lỏi máy_bay chiếc xe_đạp ba bánh có
cái Tý hai hàng nước_mắt ròng_ròng , hôn_hít các em một lượt , rồi lủi_thủi , nó đội mê nón trên đầu và cắp gói áo vào nách	Tý nước_mắt ròng_ròng em hôn_hít nón đội mê trên đầu gói áo vào nách cắp
nước ta là một , dân_tộc ta là một	nước một dân_tộc một
nhân_dân như nước , bộ_đội như cá	nhân_dân nước bộ_đội cá
mọi người đi rồi chỉ còn thằng bé Tun ở nhà	người đi chỉ còn thằng bé Tun nhà ở
hoa bưởi thơm rồi : đêm đã khuya	hoa bưởi thơm đêm khuya
Lương bật đèn_pin nhìn đồng_hồ tay : hai giơ rưỡi sáng	Lương đèn_pin bật đồng_hồ tay nhìn giờ hai rưỡi sáng
bên vệ đường có hai cha_con làm_ruộng : cha đánh cày , con đập đất	vệ đường cha_con làm_ruộng hai cha cày đánh con đất đập
chị Hoàng chạy lại buýp phê lấy một quyển sách bìa dày gáy da đem lại	Hoàng sách một lấy bìa dày da gáy đem
mình đọc hay tôi đọc	mình đọc hay tôi đọc
hoặc là chúng_ta phải nghĩ tới nhân_dân ; hoặc là chúng_ta chỉ lo_lắng cho riêng mình	chúng_ta nhân_dân nghĩ chúng_ta mình lo_lắng
chợ không họp vì không phải phiên	chợ không họp vì không phải phiên
người_ta đã yêu_mến anh là vì_thế	người_ta anh yêu_mến
hai mục_đích khác_nhau , nên phương_pháp khoa_học và kỹ_thuật để đạt đến mục_đích cũng khác_nhau	mục_đích hai khác_nhau phương_pháp khoa_học kỹ_thuật đạt mục_đích khác_nhau
em đã sống , bởi_vì em chiến thắng	em sống bởi_vì em chiến thắng
hễ tôi hơi động vào mình nó , nó lại lè lưỡi ra y_như thường_ngày	tôi hơi động nó nó lè lưỡi
thời_đại biến_đổi thì văn_học cũng biến_đổi	thời_đại biến_đổi văn_học biến_đổi
bố ạ ! nếu thế_thì con đã gặp anh Sạ	bố con Sạ gặp
miễn_là đứng trên lập_trường tư_tưởng đại_chúng nhân_dân mà giải_quyết thì ta vẫn có_thể vận_dụng mọi hình_thức , ta vẫn hết_sức tự_do trong sự lựa_chọn đề_tài	trên lập_trường tư_tưởng đại_chúng nhân_dân mà giải_quyết thì ta hình_thức vận_dụng ta tự_do lựa_chọn đề_tài
văn có hay tác_phẩm mới có giá_trị	văn có tác_phẩm giá_trị có
Việt_Minh mà lên được thì dân đỡ khổ ông nhỉ	Việt_Minh lên thì dân khổ đỡ
tuy rất đẹp nhưng mùa nào thức ấy	tđẹp nhưng mùa nào thức ấy
tuy miệng cười_nói vậy_mà bụng ông cũng rối_bời lên	miệng cười_nói vậy_mà bụng ông rối_bời
mặc_dù vậy đối_với gia_đình vợ , Thứ vẫn cố_ý không thân_mật lắm	đối_với gia_đình vợ Thứ thân_mật cố_ý không
	
chiếc xe càng đến gần phố Hàng_Cót , Phượng càng hồi_hộp	xe đến gần phố Hàng_Cót Phượng hồi_hộp
ngoài kia tiếng gõ_cửa mạnh bao_nhiêu , trong này trống_ngực tôi mạnh bấy_nhiêu	ngoài kia tiếng gõ_cửa mạnh bao_nhiêu trong này trống_ngực tôi mạnh bấy_nhiêu
giai_cấp nào nắm quyền_sở_hữu về tư_liệu_sản_xuất thì giai_cấp đó là giai_cấp thống_trị	giai_cấp quyền_sở_hữu tư_liệu_sản_xuất nắm giai_cấp thống_trị
càng đi xuống phong_cách càng quen mắt	đi xuống phong_cách quen mắt
tôi cố nói rất tự_nhiên để anh không một_chút nghi_ngờ	tôi tự_nhiên nói anh không một_chút nghi_ngờ
để cho mẹ yên_tâm , cô thường viết thư cho mẹ	mẹ yên_tâm cô thường thư cho mẹ viết
anh đánh đàn cho tôi nghe	anh đàn đánh tôi nghe
vô_luận kẻ địch hung_bạo thế_nào , hễ đụng vào lực_lượng đó thì địch nào cũng phải tan_rã	vô_luận địch hung_bạo lực_lượng đụng thì địch tan_rã
đương_nhiên , không phải thơ nào cũng cách_mạng cả , nhưng có cách_mạng thì_có thơ	đương_nhiên không phải thơ nào cách_mạng cả nhưng có cách_mạng thì_có thơ
càng chiến_đấu oanh_liệt , càng thắng_lợi giòn_giã , càng sản_xuất càng xây_dựng khỏe bao_nhiêu , nhân_dân ta càng yêu_quý văn_nghệ bấy_nhiêu , bởi_vì văn_nghệ là tinh_hoa của cuộc_sống , là một sức_mạnh , là một vũ_khí chiến_đấu và để chiến_thắng	oanh_liệt chiến_đấu giòn_giã thắng_lợi sản_xuất xây_dựng khỏe nhân_dân văn_nghệ yêu_quý bởi_vì văn_nghệ tinh_hoa cuộc_sống là sức_mạnh vũ_khí chiến_đấu chiến_thắng
nhà_nước của chúng_ta thật_sự dân_chủ , vì nhà_nước đó thực_sự là của dân , sứ_mạng lịch_sử của nó là huy_động lực_lượng của nhân_dân để xây_dựng xã_hội mới , đời_sống mới , con_người mới	nhà_nước dân_chủ nhà_nước của dân lực_lượng nhân_dân huy_động xã_hội mới xây_dựng đời_sống mới con_người mới
cái cảnh trăng_tròn , gió mát , hồ lặng , trời xanh của trung_thu , lại làm cho các cháu vui_cười hớn_hở	trăng_tròn gió mát hồ lặng trời xanh trung_thu các cháu vui_cười hớn_hở
	
Trời ấm_áp	Trời ấm_áp
Không_khí êm_ả và trong_sạch	Không_khí êm_ả trong_sạch
ngoài xa , dòng_sông lào_xào vỗ sóng	xa dòng_sông sóng vỗ
Gió chạy loạt_soạt trong cỏ	Gió loạt_soạt chạy trong cỏ
trăng đã lên cao , đêm đã khuya lắm	trăng cao đêm khuya
muốn ấm_no thì_phải làm_gì	ấm_no làm_gì
Phải làm thế_nào	làm thế_nào
Phải tăng_gia_sản_xuất	tăng_gia_sản_xuất Phải
đợi A_Phủ nói xong với vợ , anh Liên thân_mật hỏi : Tây bắt A_Phủ mấy hôm	A_Phủ nói xong Liên thân_mật hỏi Tây A_Phủ bắt hôm mấy
Làm_sao mà trốn về được	trốn về Làm_sao
nó làm ra_vẻ ngạc_nhiên , không hề biết gì	nó ngạc_nhiên biết không gì
văn_học nghệ_thuật là gì , xưa_nay người_ta đã định_nghĩa nhiều rồi	văn_học nghệ_thuật xưa_nay người_ta đã định_nghĩa
dưới cờ Việt_Minh , đồng_bào hãy dũng_cảm tiến lên	dưới cờ Việt_Minh đồng_bào hãy dũng_cảm tiến lên
từ bấy_giờ đến bây_giờ , hơn sáu năm trời rồi	bấy_giờ bây_giờ hơn sáu năm
Biết_bao_nhiêu là sự đổi_thay	Biết_bao_nhiêu là đổi_thay
thật vĩ_đại , người chiến_sĩ trong gian_khổ nghìn_trùng càng cao vời_vợi ý_chí diệt thù cứu nước	vĩ_đại chiến_sĩ trong gian_khổ nghìn_trùng cao vời_vợi ý_chí thù diệt nước cứu
yêu Bác , lòng ta trong sách hơn	Bác yêu lòng ta trong sách hơn
nỗi_niềm xưa , nghĩ mà thương	nỗi_niềm xưa thương nghĩ
ôi_chao , những việc_làm mở_đường , tạo lối đi cho kẻ đến sau bao_giờ cũng nghiêm_trang và khó_nhọc	việc_làm mở_đường lối đi tạo cho kẻ đến sau bao_giờ nghiêm_trang và khó_nhọc
nói_tóm_lại , mỗi cán_bộ , mỗi hội_viên phải học lí_luận , phải đem lí_luận áp_dụng vào thực_tế	nói_tóm_lại cán_bộ hội_viên lí_luận phải học lí_luận phải đem thực_tế áp_dụng
trong cuộc họp , tôi đã nêu câu_hỏi ấy lên , câu_hỏi quan_trọng nhất	trong cuộc họp tôi đã câu_hỏi nêu nhất quan_trọng
những đòn tre , những thanh tre , những liếp nứa đã bắc qua cầu , đã mở_đường cho anh bộ_đội tiến lên , nước Việt_Nam tiến lên	đòn tre thanh tre liếp nứa cầu bắc bộ_đội mở_đường tiến lên Việt_Nam tiến
từng bụi tre , vườn chè , vườn cọ , con ngòi , đám ruộng đã quen_thuộc , đáng yêu không khác_gì nơi quê_hương mình rồi	bụi tre vườn chè vườn cọ ngòi ruộng quen_thuộc yêu không khác_gì nơi quê_hương mình
tre , nứa , mai , vầu giúp người trăm_nghìn công_việc khác_nhau	tre nứa mai vầu người trăm_nghìn công_việc khác_nhau giúp
cán_bộ của Đảng , của Nhà_nước và của các đoàn_thể nhân_dân , đảng_viên và đoàn_viên thanh_niên lao_động cần phải xung_phong gương_mẫu trong sản_xuất và công_tác	cán_bộ Đảng Nhà_nước đoàn_thể nhân_dân đảng_viên và đoàn_viên thanh_niên lao_động gương_mẫu xung_phong trong sản_xuất và công_tác
thân tôi khổ , thân Ngói cũng khổ	thân tôi khổ thân Ngói khổ
tuy_vậy , làm thơ không phải dễ	tuy_vậy làm thơ không phải dễ
sáng_tạo là vấn_đề rất quan_trọng ; không sáng_tạo không làm cách_mạng được	sáng_tạo vấn_đề quan_trọng không sáng_tạo không làm cách_mạng được
phải đẩy_mạnh tốc_độ cơ_giới_hóa nông_nghiệp ; đẩy_mạnh cải_tạo giống gia_súc và cây_trồng nhằm thực_hiện thâm_canh trên toàn_bộ diện_tích trồng_trọt	tốc_độ cơ_giới_hóa nông_nghiệp đẩy_mạnh giống gia_súc và cây_trồng cải_tạo thực_hiện thâm_canh trên toàn_bộ diện_tích trồng_trọt
tôi chào rồi hỏi : " Đi chợ huyện nào , ông làm_ơn chỉ giúp tôi "	tôi chào hỏi Đi chợ huyện nào ông chỉ giúp tôi làm_ơn
anh_ta bày cho tôi một_cách : đứng đợi đấy , gặp ai gánh hàng đi chợ thì đi theo	anh_ta tôi một_cách bày đứng đợi ai gánh hàng gặp chợ đi đi theo
những chuyện vui , chuyện buồn , chuyện gia_đình , chuyện hàng_xóm , … kể mãi không hết	chuyện vui chuyện buồn chuyện gia_đình chuyện hàng_xóm kể mãi không hết
anh lấy áo … lấy chăn tôi … mặc vào … mặc đi	anh áo lấy chăn tôi lấy mặc vào mặc đi
chồng chị - anh Nguyễn_Văn_Dậu - tuy mới 26 tuổi nhưng đã học nghề làm_ruộng đến mười_bảy năm	chồng chị Nguyễn_Văn_Dậu tuy mới 26 tuổi nhưng học nghề làm_ruộng năm mười_bảy
thế hai bác đã đặt tên cháu chưa	hai bác tên cháu đặt chưa
tôi sẽ thi_hành nhiệm_vụ - người chiến_sĩ nói	tôi nhiệm_vụ thi_hành chiến_sĩ nói
sau khi đến được ba ngày , anh hỏi tôi " Anh dân , anh có biết viết chữ_quốc_ngữ không ? "	ba ngày được anh tôi hỏi Anh dân chữ_quốc_ngữ biết viết không
Tôi hơi thẹn nhưng trả_lời thành_thật : " không , tôi không biết "	Tôi thẹn nhưng trả_lời thành_thật không
mỗi ngày thương_lái mua ít_nhất 6 tấn chuối_lùn còn xanh ở Quảng_Ngãi , ngâm vào bể pha hóa_chất trước khi đóng_gói đưa đi tiêu_thụ	ngày thương_lái 6 tấn chuối_lùn xanh mua Quảng_Ngãi hóa_chất ngâm trước đóng_gói tiêu_thụ
liên_tục trong hai tuần qua , nhiều thương_lái thuê hàng chục lao_động từ các tỉnh phía Bắc vào xã Tịnh_Hà , huyện Sơn_Tịnh , nơi có hàng trăm hộc dân trồng chuối_lùn ven sông Trà KHúc , để mở đại_lý thu_mua chuối_lùn còn xanh xuất sang Trung_Quốc	tuần hai liên_tục thương_lái hục lao_động thuê từ các tỉnh phía Bắc vào Tịnh_Hà Sơn_Tịnh có hàng trăm hộc dân chuối_lùn trồng ven sông Trà KHúc đại_lý mở chuối_lùn còn xanh thu_mua xuất Trung_Quốc
Ông Hoàng_Văn_Thiện cho_biết , mỗi buổi_sáng , ông chủ người Trung_Quốc mang thùng catton đựng đầy các lọ nhựa hóa_chất để hòa vào bể dã_chiến phủ bạt đầy nước	Hoàng_Văn_Thiện cho_biết buổi_sáng chủ Trung_Quốc thùng catton mang lọ nhựa hóa_chất đựng hòa vào bể dã_chiến phủ bạt đầy nước
con hãy ngừng ngay cái việc đáng đánh_đòn ấy	ngừng ngay việc đáng đánh_đòn
mày câm cái mồm đi	mày mồm câm
bỏ xuống đây	bỏ xuống đây
ăn gì to_lớn đẫy_đà làm_sao	ăn gì to_lớn đẫy_đà làm_sao
thế_thì có khổ cho tôi không	thế_thì tôi khổ
người đâu mà vô_tâm	người đâu mà vô_tâm
tổ_quốc có bao_giờ đẹp thế_này chăng	tổ_quốc có bao_giờ đẹp thế_này chăng
nhằm thẳng quân_thù , bắn	nhằm quân_thù bắn
ngủ đi	
mây ơi , hãy ngừng trôi	mây trôi hãy ngừng
lá ơi , đừng rụng nữa	lá ơi rụng đừng
đừng xanh như lá , bạc như vôi	xanh như lá bạc như vôi đừng
hãy tươi mãi màu xanh_tươi ánh thép	màu xanh_tươi tươi mãi ánh thép hãy
xin các bạn giữ trật_tự	xin bạn trật_tự
các bạn giữ trật_tự	bạn trật_tự
các bạn có giữ trật_tự không nào	bạn trật_tự không
anh_ta có tài mà chẳng có đức	anh_ta tài có đức chẳng có
việc này khó lắm đấy	việc này khó lắm đấy
em ơi , buồn làm_chi	em buồn làm_chi
thế có khổ không	thế khổ có
những ngày tôi đang sống đáng sống bao_nhiêu	những ngày tôi sống đáng sống bao_nhiêu
đẹp quá nhỉ	đẹp quá
cuốn truyện này rất hay	cuốn truyện này hay
cuốn truyện này không hay	cuốn truyện này hay không
cuốn truyện này không hay lắm	cuốn truyện này hay không
thanh này không dài bằng thanh kia	thanh này thanh kia không dài bằng
thanh này ngắn hơn thanh kia	thanh này thanh kia ngắn hơn
rẻ thì_có rẻ , nhưng không đẹp	rẻ thì_có rẻ nhưng đẹp không
nó có giận anh thật , nhưng không ghét anh đâu	anh nó giận có nhưng ghét không
cháu đã làm bài thi toán	cháu bài thi toán làm đã
bài thi toán cháu được nửa điểm	bài thi toán cháu nửa điểm
vì_thế là nhiều đối_với cháu	vì_thế đối_với cháu nhiều
cháu kén quá đấy	cháu kén quá
còn bạc còn tiền còn đệ_tử	bạc còn tiền còn đệ_tử còn
Nam trêu em bé	bé Nam trêu
em bé khóc	bé khóc
gió đánh cành tre	cành tre gió đánh
gió thổi , mây bay	thổi gió bay mây
công_việc đang bộn_bề	công_việc bộn_bề
mọi lí_thuyết đều xám	lí_thuyết mọi xám đều
Nam là học_sinh giỏi	Nam học_sinh giỏi
đáng tiếc thật	thật tiếc
đèn đêm đã bật , sân_bay lại bắt_đầu làm_việc	đèn đêm bật sân_bay bắt_đầu làm_việc
vào đâu tre cũng sống , ở đâu tre cũng xanh tốt	vào đâu tre sống đâu tre xanh tốt
nước reo quanh chân lúa , lúa rung lên , lòng người cũng rung lên	nước quanh chân lúa reo lúa rung lòng người rung
ngoài đình , trống lại thúc , mõ lại khua , tù_và rúc liên_thanh bất chỉ	ngoài đình trống thúc mõ khua tù_và liên_thanh rúc
cằm ông bạnh ra , mắt ông trợn_trừng , cả người ông như một pho tượng bằng đồng_đen cuồn_cuộn những bắp_thịt	cằm ông bạnh ra mắt trợn_trừng cả người pho tượng bằng đồng_đen cuồn_cuộn bắp_thịt
những chiếc ô_tô chạy đi , chạy lại như những con_thoi , máy_bay_phản_lực rít ào_ào và len_lỏi giữa tất_cả những ô_tô , máy_bay ấy có một chiếc xe_đạp ba bánh	ô_tô chạy đi chạy như con_thoi máy_bay_phản_lực rít và len_lỏi máy_bay chiếc xe_đạp ba bánh có
cái Tý hai hàng nước_mắt ròng_ròng , hôn_hít các em một lượt , rồi lủi_thủi , nó đội mê nón trên đầu và cắp gói áo vào nách	Tý nước_mắt ròng_ròng em hôn_hít nón đội mê trên đầu gói áo vào nách cắp
nước ta là một , dân_tộc ta là một	nước một dân_tộc một
nhân_dân như nước , bộ_đội như cá	nhân_dân nước bộ_đội cá
mọi người đi rồi chỉ còn thằng bé Tun ở nhà	người đi chỉ còn thằng bé Tun nhà ở
hoa bưởi thơm rồi : đêm đã khuya	hoa bưởi thơm đêm khuya
Lương bật đèn_pin nhìn đồng_hồ tay : hai giơ rưỡi sáng	Lương đèn_pin bật đồng_hồ tay nhìn giờ hai rưỡi sáng
bên vệ đường có hai cha_con làm_ruộng : cha đánh cày , con đập đất	vệ đường cha_con làm_ruộng hai cha cày đánh con đất đập
chị Hoàng chạy lại buýp phê lấy một quyển sách bìa dày gáy da đem lại	Hoàng sách một lấy bìa dày da gáy đem
mình đọc hay tôi đọc	mình đọc hay tôi đọc
hoặc là chúng_ta phải nghĩ tới nhân_dân ; hoặc là chúng_ta chỉ lo_lắng cho riêng mình	chúng_ta nhân_dân nghĩ chúng_ta mình lo_lắng
chợ không họp vì không phải phiên	chợ không họp vì không phải phiên
người_ta đã yêu_mến anh là vì_thế	người_ta anh yêu_mến
hai mục_đích khác_nhau , nên phương_pháp khoa_học và kỹ_thuật để đạt đến mục_đích cũng khác_nhau	mục_đích hai khác_nhau phương_pháp khoa_học kỹ_thuật đạt mục_đích khác_nhau
em đã sống , bởi_vì em chiến thắng	em sống bởi_vì em chiến thắng
hễ tôi hơi động vào mình nó , nó lại lè lưỡi ra y_như thường_ngày	tôi hơi động nó nó lè lưỡi
thời_đại biến_đổi thì văn_học cũng biến_đổi	thời_đại biến_đổi văn_học biến_đổi
bố ạ ! nếu thế_thì con đã gặp anh Sạ	bố con Sạ gặp
miễn_là đứng trên lập_trường tư_tưởng đại_chúng nhân_dân mà giải_quyết thì ta vẫn có_thể vận_dụng mọi hình_thức , ta vẫn hết_sức tự_do trong sự lựa_chọn đề_tài	trên lập_trường tư_tưởng đại_chúng nhân_dân mà giải_quyết thì ta hình_thức vận_dụng ta tự_do lựa_chọn đề_tài
văn có hay tác_phẩm mới có giá_trị	văn có tác_phẩm giá_trị có
Việt_Minh mà lên được thì dân đỡ khổ ông nhỉ	Việt_Minh lên thì dân khổ đỡ
tuy rất đẹp nhưng mùa nào thức ấy	tđẹp nhưng mùa nào thức ấy
tuy miệng cười_nói vậy_mà bụng ông cũng rối_bời lên	miệng cười_nói vậy_mà bụng ông rối_bời
mặc_dù vậy đối_với gia_đình vợ , Thứ vẫn cố_ý không thân_mật lắm	đối_với gia_đình vợ Thứ thân_mật cố_ý không
	
chiếc xe càng đến gần phố Hàng_Cót , Phượng càng hồi_hộp	xe đến gần phố Hàng_Cót Phượng hồi_hộp
ngoài kia tiếng gõ_cửa mạnh bao_nhiêu , trong này trống_ngực tôi mạnh bấy_nhiêu	ngoài kia tiếng gõ_cửa mạnh bao_nhiêu trong này trống_ngực tôi mạnh bấy_nhiêu
giai_cấp nào nắm quyền_sở_hữu về tư_liệu_sản_xuất thì giai_cấp đó là giai_cấp thống_trị	giai_cấp quyền_sở_hữu tư_liệu_sản_xuất nắm giai_cấp thống_trị
càng đi xuống phong_cách càng quen mắt	đi xuống phong_cách quen mắt
tôi cố nói rất tự_nhiên để anh không một_chút nghi_ngờ	tôi tự_nhiên nói anh không một_chút nghi_ngờ
để cho mẹ yên_tâm , cô thường viết thư cho mẹ	mẹ yên_tâm cô thường thư cho mẹ viết
anh đánh đàn cho tôi nghe	anh đàn đánh tôi nghe
vô_luận kẻ địch hung_bạo thế_nào , hễ đụng vào lực_lượng đó thì địch nào cũng phải tan_rã	vô_luận địch hung_bạo lực_lượng đụng thì địch tan_rã
đương_nhiên , không phải thơ nào cũng cách_mạng cả , nhưng có cách_mạng thì_có thơ	đương_nhiên không phải thơ nào cách_mạng cả nhưng có cách_mạng thì_có thơ
càng chiến_đấu oanh_liệt , càng thắng_lợi giòn_giã , càng sản_xuất càng xây_dựng khỏe bao_nhiêu , nhân_dân ta càng yêu_quý văn_nghệ bấy_nhiêu , bởi_vì văn_nghệ là tinh_hoa của cuộc_sống , là một sức_mạnh , là một vũ_khí chiến_đấu và để chiến_thắng	oanh_liệt chiến_đấu giòn_giã thắng_lợi sản_xuất xây_dựng khỏe nhân_dân văn_nghệ yêu_quý bởi_vì văn_nghệ tinh_hoa cuộc_sống là sức_mạnh vũ_khí chiến_đấu chiến_thắng
nhà_nước của chúng_ta thật_sự dân_chủ , vì nhà_nước đó thực_sự là của dân , sứ_mạng lịch_sử của nó là huy_động lực_lượng của nhân_dân để xây_dựng xã_hội mới , đời_sống mới , con_người mới	nhà_nước dân_chủ nhà_nước của dân lực_lượng nhân_dân huy_động xã_hội mới xây_dựng đời_sống mới con_người mới
cái cảnh trăng_tròn , gió mát , hồ lặng , trời xanh của trung_thu , lại làm cho các cháu vui_cười hớn_hở	trăng_tròn gió mát hồ lặng trời xanh trung_thu các cháu vui_cười hớn_hở
	
Trời ấm_áp	Trời ấm_áp
Không_khí êm_ả và trong_sạch	Không_khí êm_ả trong_sạch
ngoài xa , dòng_sông lào_xào vỗ sóng	xa dòng_sông sóng vỗ
Gió chạy loạt_soạt trong cỏ	Gió loạt_soạt chạy trong cỏ
trăng đã lên cao , đêm đã khuya lắm	trăng cao đêm khuya
muốn ấm_no thì_phải làm_gì	ấm_no làm_gì
Phải làm thế_nào	làm thế_nào
Phải tăng_gia_sản_xuất	tăng_gia_sản_xuất Phải
đợi A_Phủ nói xong với vợ , anh Liên thân_mật hỏi : Tây bắt A_Phủ mấy hôm	A_Phủ nói xong Liên thân_mật hỏi Tây A_Phủ bắt hôm mấy
Làm_sao mà trốn về được	trốn về Làm_sao
nó làm ra_vẻ ngạc_nhiên , không hề biết gì	nó ngạc_nhiên biết không gì
văn_học nghệ_thuật là gì , xưa_nay người_ta đã định_nghĩa nhiều rồi	văn_học nghệ_thuật xưa_nay người_ta đã định_nghĩa
dưới cờ Việt_Minh , đồng_bào hãy dũng_cảm tiến lên	dưới cờ Việt_Minh đồng_bào hãy dũng_cảm tiến lên
từ bấy_giờ đến bây_giờ , hơn sáu năm trời rồi	bấy_giờ bây_giờ hơn sáu năm
Biết_bao_nhiêu là sự đổi_thay	Biết_bao_nhiêu là đổi_thay
thật vĩ_đại , người chiến_sĩ trong gian_khổ nghìn_trùng càng cao vời_vợi ý_chí diệt thù cứu nước	vĩ_đại chiến_sĩ trong gian_khổ nghìn_trùng cao vời_vợi ý_chí thù diệt nước cứu
yêu Bác , lòng ta trong sách hơn	Bác yêu lòng ta trong sách hơn
lúc ấy có_thể nghe thấy một cái tác rất kêu	lúc ấy tát nghe
lúc ấy có_thể nghe thấy tiếng đấm_đá nhau bình_bịch	lúc ấy có_thể đấm_đá nghe bình_bịch
đấm_đá như_thế cứ gọi_là tan xương	đấm_đá như_thế tan xương
đại_bác ùng_oàng suốt đêm	đại_bác ùng_oàng suốt đêm
tiếng ùng_oàng của đại_bác nghe thưa dần	tiếng đại_bác ùng_oàng nghe thưa dần
có_tiếng đại_bác nổ ùng_oàng từ xa	xa có_tiếng đại_bác ùng_oàng
điều ấy tôi biết rồi	điều ấy tôi biết rồi
điều anh vừa nói ấy tôi biết rồi	điều anh vừa nói tôi biết
tôi đã xem trận ấy	tôi trận ấy đã xem
tôi đã xem đội ta đấu với đội bạn	tôi xem đội ta đội bạn đấu
vì lợi_ích chung ông_ta đã xin từ_chức	vì lợi_ích chung ông_ta từ_chức xin
Cụ Tú đã bạc hết cả tóc rồi	Cụ Tú tóc bạc hết
Cụ Tú tóc bạc hết cả rồi	Cụ Tú tóc bạc hết
ôi , cảnh ly_biệt mà_sao buồn vậy	ly_biệt mà_sao buồn
anh Đức này , anh lấy tôi làm vợ nhé	anh Đức anh tôi lấy làm vợ
ông Chưởng , phó của cha tôi , nay đã lên tướng	ông Chưởng phó cha tôi nay lên tướng
anh có biết ông ấy không , ông Văn ấy mà	anh ông ấy biết Văn
không ai nói_gì , mọi người lảng dần ra	ai nói_gì không mọi người lảng dần
không ai nói_gì , rồi mọi người lảng dần ra	ai nói_gì không mọi người lảng dần
không ai nói_gì nhưng mọi người lảng dần ra	ai nói_gì không nhưng mọi người lảng dần
không ai nói_gì nên mọi người lảng dần ra	ai nói_gì không nên mọi người lảng dần
tuy không ai nói_gì nhưng mọi người lãng dần ra	tuy ai nói_gì không nhưng mọi người lãng dần
vì không ai nói_gì nên mọi người lãng dần	vì ai nói_gì không nên mọi người lãng dần
đã bấy_lâu_nay bác tới nhà	đã bấy_lâu_nay bác tới nhà
trẻ thời đi vắng , chợ thời xa	trẻ thời đi vắng chợ thời xa
ao sâu nước cả , khôn chài cá	ao nước sâu khôn chài cá
vườn rộng rào thưa , khó duổi gà	vườn rộng rào thưa gà khó duổi
cải chửa ra cây , cà mới nụ	cải cây chửa ra cà nụ mới
bầu vừa rụng rốn , mướp ra hoa	bầu rốn rụng mướp hoa ra
đầu_trò tiếp khách trầu_không có	đầu_trò khách tiếp trầu_không có
bác đến chơi đây , ta với ta	bác đến chơi đây ta với ta
tôi cũng không biết	tôi không biết cũng
sao anh lại nói thế	anh nói sao
chuyện này nghiêm_trọng đây	chuyện này nghiêm_trọng
nhưng ai biết mà sợ	biết ai mà sợ
sau đây là vài điểm cần nói rõ thêm	sau đây vài điểm nói rõ cần
tôi không dính vào việc này	tôi dính không vào
anh cũng đừng nghi_ngờ gì anh_ấy	anh nghi_ngờ đừng anh_ấy
có những mười người vắng_mặt	có người mười vắng_mặt
gã kia làm hỏng cái máy mất	gã kia máy làm hỏng
nó cố_ý làm hỏng cái máy thật	nó máy làm hỏng cố_ý
Nam sẽ trúng_cử đó là một điều chắc_chắn	Nam trúng_cử là điều chắc_chắn
thế_mà quả thị , lạ thay , vẫn không rơi xuống	thế_mà quả thị rơi xuống không lạ
của_đáng_tội , nó có biết gì đâu	của_đáng_tội nó biết gì
luật này , như ai_nấy đều biết , có một phạm_vi hiệu luật rất hẹp	ai_nấy đều biết luật này phạm_vi hiệu luật hẹp
nó làm rách cái màn mất	nó cái màn làm rách
nó làm rách mất cái màn	nó cái màn làm rách
nó làm rách cái màn mất rồi	nó cái màn làm rách
vì không đọc kỹ đề , nó đã làm hỏng mất bài tập_làm_văn	đề đọc kỹ không nó tập_làm_văn hỏng
tớ sẽ được điểm 10 về môn toán một_cách chắc_chắn	tớ toán điểm 10 được
tôi chỉ tập_trung tư_tưởng được trong vòng một giờ đồng_hồ	tôi tư_tưởng tập_trung được một giờ
ông ấy làm_việc liên_tục suốt từ sáng đến chiều	ông ấy làm_việc sáng chiều liên_tục
nó làm hỏng bài tập_làm_văn vì không đọc kỹ đề_bài	nó tập_làm_văn làm hỏng vì đề_bài đọc không kỹ
suốt từ sáng đến chiều , ông ấy làm_việc liên_tục	sáng chiều ông ấy làm_việc liên_tục
chắc_chắn là tớ sẽ được điểm 10 về môn toán	tớ toán điểm 10 được chắc_chắn
nó hỏng kì thi này vì môn toán	nó toán thi hỏng
nó hỏng kì thi này vì dốt	nó thi hỏng vì dốt
nó hỏng kì thi này vì lạc_đề	nó thi hỏng vì lạc_đề
nó hỏng kì thi này vì đề thi khó quá	nó thi hỏng vì đề khó
em ơi buồn làm_chi	em buồn làm_chi
vần vấn_đề này thưa các bạn chúng_ta có rất nhiều ý_kiến	các bạn chúng_ta vấn_đề này ý_kiến nhiều có
cậu Vàng đi_đời rồi ông giáo ạ	ông giáo cậu Vàng đi_đời rồi
mà chàng quên chí cao vì sự_nghiệp	mà chàng sự_nghiệp chí cao vì
giời_ơi là giời , có chồng_con nhà nào như_thế không	giời_ơi giời có chồng_con nhà nào như_thế
sau trúc , ô_kìa	trúc sau ô_kìa
Xiêm_áo ai	Xiêm_áo ai
trời_đất ạ , có đời_nào như_vậy , cái thổ_tả gì cũng đắt	trời_đất có đời_nào như_vậy thổ_tả gì đắt cũng
vâng , mời bà cứ ngồi chơi thư_thả xơi nước , xơi trầu đã	mời bà ngồi chơi nước xơi trầu xơi
ô_hay , con làm_gì	ô_hay con làm_gì
vâng , tôi biết	vâng tôi biết
Tính ông Cửu nhà tôi nhân lão tâm bất lão	tính ông Cửu tôi nhân lão tâm bất lão
ô_hay , mẹ_con nó đi đâu cả rồi	ô_hay mẹ_con đâu
cô bé nhà bên ai_ngờ cũng là du_kích	cô bé nhà bên ai_ngờ là du_kích
ông Năm ấy mà , ông ấy tốt lắm	ông Năm tốt
điều ta không muốn thì không nên làm cho người khác	ta điều muốn không làm cho người khác nên không
bằng_lòng hay không thì cũng nói cho ngta biết	bằng_lòng hay không thì nói người_ta biết
dễ người dễ ta	dễ người dễ ta
	
lắm thầy rầy ma	thầy lắm ma rầy
tôi thì làm được	tôi làm được
con tôi đứa thì đi làm , đứa thì đi học	con tôi đứa làm đứa học
món này ăn thì ngon nhưng làm thì mất_công	món này ngon nhưng làm mất_công
việc này không chóng thì chầy cũng sẽ đưa đến kết_quả xấu	việc này không chóng thì chầy kết_quả xấu
anh_em ở đây không_ít_thì_nhiều đều có đóng_góp	anh_em ở đây không_ít_thì_nhiều đóng_góp có
hình_như anh hài_lòng lắm thì_phải	hình_như anh hài_lòng
anh Nam làm_việc thì chăm_chỉ	Nam làm_việc chăm_chỉ
anh Nam làm_việc chăm_chỉ	Nam làm_việc chăm_chỉ
anh mời thì tôi đến	anh mời tôi đến
anh mời tôi đến	anh mời tôi đến
thấy địch thì khai_triển đội_hình	địch thấy thì đội_hình khai_triển
thấy địch khai_triển đội_hình	địch thấy đội_hình khai_triển
khi tàu chạy thì về	tàu chạy thì về
khi tàu chạy về	khi tàu về
không làm , không ăn	làm không ăn không
không làm thì không ăn	làm không thì ăn không
cần gì , nói ngay đi	cần nói
cần gì thì nói ngay đi	cần thì nói
Không làm thì không ăn đấy nhé	làm không thì ăn không
cần gì thì nói ngay đi , thưa bẩm mãi	cần gì thì nói bẩm mãi
cần gì ? nói ngay đi	cần gì ? nói
chó treo , mèo đậy	chó treo mèo đậy
mềm nắn , rắn buông	mềm nắn rắn vuông
cá cả , lợn lớn	cá cả lợn lớn
trên thuận dưới hòa	trên thuận dưới hòa
trong thì ấm , ngoài thì êm	trong ấm ngoài êm
bói thì_ra ma , quét nhà thì_ra rác	bói thì_ra nhà quét rác thì_ra
trong có ấm thì ngoài mới có êm	trong ấm thì ngoài êm
bói mà ra ma thì quét nhà ra rác	bói ma ra thì nhà quét rác
trời thì mưa lâm_thâm	mưa lâm_thâm
làm_sao cho khỏi ướt	ướt làm_sao
mọi người đi trước cả rồi , còn tôi thì tôi sẽ đi_sau	mọi người đi rồi , tôi đi_sau sẽ
ai chứ , anh Ba thì khỏi phải giới_thiệu	giới_thiệu Ba phải khỏi
tôi thương mẹ nhất	tôi mẹ thương nhất
khi có nhiều mây đen thì sẽ có lũ_lụt	khi mây đen nhiều thì lũ_lụt có
khi trời mưa tạnh thì sẽ có cầu vòng	khi mưa tạnh cầu vòng có
anh tôi đánh ông bình	anh tôi Bình đánh
ông bình bị anh tôi đánh	anh tôi Bình đánh
cuốn sách đặt trên tập nhạc	tập nhạc cuốn sách trên
ra lấy áo_quần vào đi con	ra áo_quần lấy
con đã cất áo_quần vào chưa	con áo_quần cất chưa
sắp mưa rồi đấy	mưa sắp
tập nhạc đặt dưới cuốn sách	cuốn sách tập nhạc dưới
trời sắp mưa đến_nơi rồi kìa	mưa sắp
Lan ơi , mưa	Lan mưa
mày có ra lấy áo_quần vào không Lan	Lan ra áo_quần lấy
Mưa ướt hết bây_giờ	mưa ướt hết
con phải cất áo_quần vào kẻo mưa đến_nơi rồi đấy	con áo_quần cất mưa
nước sôi rồi	nước sôi rồi
trong phích có nước sôi đấy	phích nước sôi có
tôi rót nước sôi vào phích	tôi phích nước sôi rót
ông nói gà , bà nói vịt	gà ông nói vịt bà nói
ông thì nói gà , bà thì nói vịt	gà ông nói vịt bà nói
ông nói gà thì bà nói vịt	gà ông nói thì vịt bà nói
ông mà nói gà thì bà lại nói vịt	gà ông nói thì vịt bà nói
giờ ngủ thì các cháu im_lặng	giờ ngủ cháu im_lặng
ông ngủ thì các cháu nên im_lặng	ông ngủ cháu im_lặng
sách hay thì ai cũng thích đọc	sách hay ai đọc thích
sách hay người_ta mới thích đọc	sách hay người_ta đọc thích
sách mà hay thì ai cũng thích đọc	sách hay thì ai đọc thích
sách có hay thì người_ta mới thích đọc	sách hay có người_ta đọc thích
mẹ đi Hà_Nội rồi	mẹ Hà_Nội rồi
năm nay mưa ít quá	mưa năm nay ít
con mèo này không đẹp	con mèo này đẹp không
anh thì cần gì đến tôi	tôi anh cần gì
cụ Tú tóc đã bạc hết rồi	Tú tóc bạc hết rồi
vườn nhà tôi lá rụng nhiều	lá vườn nhà tôi rụng nhiều
có một người thì làm không xuể	người một làm xuể không
bây_giờ chưa muộn đâu	bây_giờ muộn chưa
tham thì thâm	tham thâm thì
bao_giờ trời nổi can_qua	trời nổi can_qua
con vua thất_thế lại đi quét chùa	vua con thất_thế chùa quét
hòn đất mà biết nói_năng thì thầy_địa_lý hàm_răng không còn	đất nói_năng biết thầy_địa_lý hàm_răng còn không
con Cún người_ta bắt mất rồi	cún người_ta bắt rồi
cây gạo đầu làng bị sét đánh_đổi rồi	đầu làng cây gạo sét đánh_đổ
còn con Cún đâu rồi	Cún đâu
con Cún thì người_ta bắt mất rồi	Cún người_ta bắt rồi
ai làm được_việc này	việc này làm được ai
tôi làm được	tôi được làm
nó chịu rồi , còn anh thì_có làm được không ạ	nó chịu rồi anh làm được
tôi thì làm được	tôi làm được
con tôi đứa thì đi làm , đứa thì đi học	con tôi đứa làm đứa học
món này ăn thì ngon nhưng làm thì mất_công	món này ngon nhưng làm mất_công
việc này không chóng thì chầy cũng sẽ đưa đến kết_quả xấu	việc này không chóng thì chầy kết_quả xấu
anh_em ở đây không_ít_thì_nhiều đều có đóng_góp	anh_em ở đây không_ít_thì_nhiều đóng_góp có
hình_như anh hài_lòng lắm thì_phải	hình_như anh hài_lòng
anh Nam làm_việc thì chăm_chỉ	Nam làm_việc chăm_chỉ
anh Nam làm_việc chăm_chỉ	Nam làm_việc chăm_chỉ
anh mời thì tôi đến	anh mời tôi đến
anh mời tôi đến	anh mời tôi đến
thấy địch thì khai_triển đội_hình	địch thấy thì đội_hình khai_triển
thấy địch khai_triển đội_hình	địch thấy đội_hình khai_triển
khi tàu chạy thì về	tàu chạy thì về
khi tàu chạy về	khi tàu về
không làm , không ăn	làm không ăn không
không làm thì không ăn	làm không thì ăn không
cần gì , nói ngay đi	cần nói
cần gì thì nói ngay đi	cần thì nói
Không làm thì không ăn đấy nhé	làm không thì ăn không
cần gì thì nói ngay đi , thưa bẩm mãi	cần gì thì nói bẩm mãi
cần gì ? nói ngay đi	cần gì ? nói
chó treo , mèo đậy	chó treo mèo đậy
mềm nắn , rắn buông	mềm nắn rắn vuông
cá cả , lợn lớn	cá cả lợn lớn
trên thuận dưới hòa	trên thuận dưới hòa
trong thì ấm , ngoài thì êm	trong ấm ngoài êm
bói thì_ra ma , quét nhà thì_ra rác	bói thì_ra nhà quét rác thì_ra
trong có ấm thì ngoài mới có êm	trong ấm thì ngoài êm
bói mà ra ma thì quét nhà ra rác	bói ma ra thì nhà quét rác
trời thì mưa lâm_thâm	mưa lâm_thâm
làm_sao cho khỏi ướt	ướt làm_sao
mọi người đi trước cả rồi , còn tôi thì tôi sẽ đi_sau	mọi người đi rồi , tôi đi_sau sẽ
ai chứ , anh Ba thì khỏi phải giới_thiệu	giới_thiệu Ba phải khỏi
nó thì nó chẳng tin được đâu	nó tin chẳng
nó thì chẳng tin được đâu	nó tin chẳng
thì_giờ là vàng_bạc	thì_giờ vàng_bạc
Hà_Nội thủ_đô nước ta	Hà_Nội thủ_đô nước ta
người là hoa đất	người hoa đất
nó chê cấm là nó ốm đấy	nó cấm chê nó ốm đấy
được tặng giải 1 một cậu_bé mười_hai tuổi	giải 1 cậu_bé mười_hai tuổi
trên thuận dưới hòa là hay nhất	trên thuận dưới hòa
trong đánh ra ngoài đánh vào thì nhất_định thắng	đánh trong ra ngoài đánh vào thì thắng nhất_định
ăn_có_nhai_nói_có_nghĩ thì mới là người khôn	ăn_có_nhai_nói_có_nghĩ là người khôn
khôn sống mống chết là một thực_tế xã_hội	khôn sống mống chết là xã_hội thực_tế
con_trâu đi trước cái cày theo sau thì còn lạc_hậu	con_trâu đi trước cày sau thì lạc_hậu còn
	
	
lỗi này tại ai thì tôi không biết	lỗi này tại ai tôi không biết
quan biết thì nó chết	quan biết nó chết
mai đã đi thì tôi chuẩn_bị không kịp	mai đi tôi chuẩn_bị không kịp
sen xa hồ sen khô hồ cạn	hồ sen xa hồ cạn
liễu xa đào liễu ngả đào nghiêng	liễu đào xa liễu ngả đào nghiêng
sớm mưa trưa nắng là anh yêu mình	mưa sớm nắng trưa là anh mình yêu
sông_cạn_đá_mòn anh vẫn thủy_chung	sông_cạn_đá_mòn anh thủy_chung vẫn
ai đi ai về nó cũng chẳng để_ý	đi ai về ai nó chẳng để_ý
sáng vác tối vác thì ai mà chả chán	vác sáng vác tối chán
đau quá	
đang bận lút đầu lút cổ	
đi đâu_đấy	đi đâu_đấy
khỏe chứ	
có đau không	đau có
cấm hút thuốc_lá	thuốc_lá hút cấm
không chạy xe trong sân	trong sân chạy xe không
coi_chừng mất xe	xe mất coi_chừng
phải tôn_trọng và giúp_đỡ người già_cả và phụ_nữ có_thai	tôn_trọng giúp_đỡ người già_cả phụ_nữ có_thai phải
cần ăn để mà sống chứ không phải sống để mà ăn	ăn sống cần chứ sống ăn không phải
ngồi xuống	
mời ngồi xuống	mời ngồi
quý_vị ngồi xuống đi	quý_vị ngồi
tôi mời quý_vị an_tọa	quý_vị an_tọa mời
cám_ơn các bạn	cám_ơn các bạn
cám_ơn các bác	cám_ơn các bác
khuya rồi	khuya rồi
nóng quá , sắp mưa rồi	nóng quá mưa sắp
như tranh_thủy_mặc ấy , đẹp quá	như tranh_thủy_mặc đẹp
nhiều bướm quá , có con đẹp quá kìa	bướm nhiều có con đẹp quá
tệ đến thế kia à	tệ thế
ở đây lúc này , trời nóng quá	ở đây lúc này nóng quá
ở đây lúc này , trời sắp mưa	ở đây lúc này mưa sắp
số tác_giả này nhận_định khác hẳn	tác_giả này nhận_định khác hẳn
đã bảo mà	bảo đã
	
một cái tát rất kêu	một tát rất kêu
tiếng đấm , tiếng đá nhau bình_bịch	đấm đá tiếng bình_bịch
họ đã bảo mà	họ bảo đã
phen này thì_phải biết	phen này thì_phải biết
lúc ấy có_thể nghe thấy một cái tác rất kêu	lúc ấy tát nghe
lúc ấy có_thể nghe thấy tiếng đấm_đá nhau bình_bịch	lúc ấy có_thể đấm_đá nghe bình_bịch
đấm_đá như_thế cứ gọi_là tan xương	đấm_đá như_thế tan xương
đại_bác ùng_oàng suốt đêm	đại_bác ùng_oàng suốt đêm
tiếng ùng_oàng của đại_bác nghe thưa dần	tiếng đại_bác ùng_oàng nghe thưa dần
đề_nghị các đồng_chí yên_lặng	đồng_chí đề_nghị yên_lặng
xin đề_nghị các đồng_chí yên_lặng	xin đồng_chí đề_nghị yên_lặng
tôi gửi các bạn lời chào thân_ái	tôi bạn gửi lời chào thân_ái
tôi xin gửi các bạn lời chào thân_ái	tôi bạn gửi lời chào thân_ái
	
tôi xin cảm_ơn	tôi cảm_ơn
các con không được cãi nhau nữa	con cãi nhau không được
anh kê cái bàn ấy ra đây cho đẹp	anh bàn kê đây đẹp
bác vào chơi xơi nước ạ	bác vào nước xơi
cái bông hoa này vẽ to quá	hoa này vẽ to
đường_sá lầy_lội kinh người	đường_sá lầy_lội kinh
chính anh làm hỏng việc chứ ai	anh làm hỏng
làm như_thế cũng được chứ sao	làm như_thế được chứ sao
lại muốn vòi tiền nữa chứ gì	muốn tiền chứ gì
anh phê_bình hay mạt_sát tôi đấy	anh tôi phê_bình mạt_sát
con hay con mèo đánh vỡ bình hoa	con hay con mèo bình hoa vỡ
cậu thích chó hơn hay mèo hơn	cậu chó mèo thích hơn
Nam tặng em bé kẹo hay nước_hoa	kẹo hay nước_hoa bé Nam tặng
mình đi xe_lửa hay máy_bay	xe_lửa hay máy_bay mình đi
cuộc họp hoãn lại một tuần hay nửa tháng	họp hoãn một tuần hay nửa tháng
ông có diêm không	ông diêm có
con muốn ăn đòn phải không	con đòn muốn
mày có câm cái mồm đi không	mày mồm câm
ông cho tôi xin tí lửa	ông lửa tôi xin
con hãy ngừng ngay cái việc đáng đánh_đòn ấy	ngừng ngay việc đáng đánh_đòn
mày câm cái mồm đi	mày mồm câm
bỏ xuống đây	bỏ xuống đây
ăn gì to_lớn đẫy_đà làm_sao	ăn gì to_lớn đẫy_đà làm_sao
thế_thì có khổ cho tôi không	thế_thì tôi khổ
người đâu mà vô_tâm	người đâu mà vô_tâm
tổ_quốc có bao_giờ đẹp thế_này chăng	tổ_quốc có bao_giờ đẹp thế_này chăng
nhằm thẳng quân_thù , bắn	nhằm quân_thù bắn
ngủ đi	
mây ơi , hãy ngừng trôi	mây trôi hãy ngừng
lá ơi , đừng rụng nữa	lá ơi rụng đừng
đừng xanh như lá , bạc như vôi	xanh như lá bạc như vôi đừng
hãy tươi mãi màu xanh_tươi ánh thép	màu xanh_tươi tươi mãi ánh thép hãy
xin các bạn giữ trật_tự	xin bạn trật_tự
các bạn giữ trật_tự	bạn trật_tự
các bạn có giữ trật_tự không nào	bạn trật_tự không
anh_ta có tài mà chẳng có đức	anh_ta tài có đức chẳng có
việc này khó lắm đấy	việc này khó lắm đấy
em ơi , buồn làm_chi	em buồn làm_chi
thế có khổ không	thế khổ có
những ngày tôi đang sống đáng sống bao_nhiêu	những ngày tôi sống đáng sống bao_nhiêu
đẹp quá nhỉ	đẹp quá
cuốn truyện này rất hay	cuốn truyện này hay
cuốn truyện này không hay	cuốn truyện này hay không
cuốn truyện này không hay lắm	cuốn truyện này hay không
thanh này không dài bằng thanh kia	thanh này thanh kia không dài bằng
thanh này ngắn hơn thanh kia	thanh này thanh kia ngắn hơn
rẻ thì_có rẻ , nhưng không đẹp	rẻ thì_có rẻ nhưng đẹp không
nó có giận anh thật , nhưng không ghét anh đâu	anh nó giận có nhưng ghét không
cháu đã làm bài thi toán	cháu bài thi toán làm đã
bài thi toán cháu được nửa điểm	bài thi toán cháu nửa điểm
vì_thế là nhiều đối_với cháu	vì_thế đối_với cháu nhiều
cháu kén quá đấy	cháu kén quá
còn bạc còn tiền còn đệ_tử	bạc còn tiền còn đệ_tử còn
Nam trêu em bé	bé Nam trêu
em bé khóc	bé khóc
gió đánh cành tre	cành tre gió đánh
gió thổi , mây bay	thổi gió bay mây
công_việc đang bộn_bề	công_việc bộn_bề
mọi lí_thuyết đều xám	lí_thuyết mọi xám đều
Nam là học_sinh giỏi	Nam học_sinh giỏi
đáng tiếc thật	thật tiếc
đèn đêm đã bật , sân_bay lại bắt_đầu làm_việc	đèn đêm bật sân_bay bắt_đầu làm_việc
vào đâu tre cũng sống , ở đâu tre cũng xanh tốt	vào đâu tre sống đâu tre xanh tốt
nước reo quanh chân lúa , lúa rung lên , lòng người cũng rung lên	nước quanh chân lúa reo lúa rung lòng người rung
ngoài đình , trống lại thúc , mõ lại khua , tù_và rúc liên_thanh bất chỉ	ngoài đình trống thúc mõ khua tù_và liên_thanh rúc
cằm ông bạnh ra , mắt ông trợn_trừng , cả người ông như một pho tượng bằng đồng_đen cuồn_cuộn những bắp_thịt	cằm ông bạnh ra mắt trợn_trừng cả người pho tượng bằng đồng_đen cuồn_cuộn bắp_thịt
những chiếc ô_tô chạy đi , chạy lại như những con_thoi , máy_bay_phản_lực rít ào_ào và len_lỏi giữa tất_cả những ô_tô , máy_bay ấy có một chiếc xe_đạp ba bánh	ô_tô chạy đi chạy như con_thoi máy_bay_phản_lực rít và len_lỏi máy_bay chiếc xe_đạp ba bánh có
cái Tý hai hàng nước_mắt ròng_ròng , hôn_hít các em một lượt , rồi lủi_thủi , nó đội mê nón trên đầu và cắp gói áo vào nách	Tý nước_mắt ròng_ròng em hôn_hít nón đội mê trên đầu gói áo vào nách cắp
nước ta là một , dân_tộc ta là một	nước một dân_tộc một
nhân_dân như nước , bộ_đội như cá	nhân_dân nước bộ_đội cá
mọi người đi rồi chỉ còn thằng bé Tun ở nhà	người đi chỉ còn thằng bé Tun nhà ở
hoa bưởi thơm rồi : đêm đã khuya	hoa bưởi thơm đêm khuya
Lương bật đèn_pin nhìn đồng_hồ tay : hai giơ rưỡi sáng	Lương đèn_pin bật đồng_hồ tay nhìn giờ hai rưỡi sáng
bên vệ đường có hai cha_con làm_ruộng : cha đánh cày , con đập đất	vệ đường cha_con làm_ruộng hai cha cày đánh con đất đập
may_vá có khó thì mới_phải học	may_vá khó thì mới_phải học
mình em nấy nướng thì không kịp	em ấy nướng không kịp
chưa nói đã cười là người vô_duyên	nói chưa cười đã người vô_duyên
Cao_Bằng gạo_trắng_nước_trong	Cao_Bằng gạo_trắng_nước_trong
ngọn đèn khi tỏ khi mờ	đèn khi tỏ khi mờ
món này ăn thì ngon làm thì tốn công	món này ngon ăn tốn công làm
ở đây trước lạ sau quen	ở đây lạ trước quen sau
lúc này gạo_châu_củi_quế	lúc này gạo_châu_củi_quế
làm cho thì thân_tàn_ma_dại	
ai về ai ở mặc ai	về ai ở ai mặc ai
trên thuận dưới hòa là hay nhất	trên thuận dưới hòa
trong đánh ra ngoài đánh vào thì nhất_định thắng	đánh trong ra ngoài đánh vào thì thắng nhất_định
ăn_có_nhai_nói_có_nghĩ thì mới là người khôn	ăn_có_nhai_nói_có_nghĩ là người khôn
khôn sống mống chết là một thực_tế xã_hội	khôn sống mống chết là xã_hội thực_tế
con_trâu đi trước cái cày theo sau thì còn lạc_hậu	con_trâu đi trước cày sau thì lạc_hậu còn
	
	
lỗi này tại ai thì tôi không biết	lỗi này tại ai tôi không biết
quan biết thì nó chết	quan biết nó chết
mai đã đi thì tôi chuẩn_bị không kịp	mai đi tôi chuẩn_bị không kịp
sen xa hồ sen khô hồ cạn	hồ sen xa hồ cạn
liễu xa đào liễu ngả đào nghiêng	liễu đào xa liễu ngả đào nghiêng
sớm mưa trưa nắng là anh yêu mình	mưa sớm nắng trưa là anh mình yêu
sông_cạn_đá_mòn anh vẫn thủy_chung	sông_cạn_đá_mòn anh thủy_chung vẫn
ai đi ai về nó cũng chẳng để_ý	đi ai về ai nó chẳng để_ý
sáng vác tối vác thì ai mà chả chán	vác sáng vác tối chán
đau quá	
đang bận lút đầu lút cổ	
đi đâu_đấy	đi đâu_đấy
khỏe chứ	
có đau không	đau có
cấm hút thuốc_lá	thuốc_lá hút cấm
không chạy xe trong sân	trong sân chạy xe không
coi_chừng mất xe	xe mất coi_chừng
phải tôn_trọng và giúp_đỡ người già_cả và phụ_nữ có_thai	tôn_trọng giúp_đỡ người già_cả phụ_nữ có_thai phải
cần ăn để mà sống chứ không phải sống để mà ăn	ăn sống cần chứ sống ăn không phải
ngồi xuống	
mời ngồi xuống	mời ngồi
quý_vị ngồi xuống đi	quý_vị ngồi
tôi mời quý_vị an_tọa	quý_vị an_tọa mời
cám_ơn các bạn	cám_ơn các bạn
cám_ơn các bác	cám_ơn các bác
khuya rồi	khuya rồi
nóng quá , sắp mưa rồi	nóng quá mưa sắp
như tranh_thủy_mặc ấy , đẹp quá	như tranh_thủy_mặc đẹp
nhiều bướm quá , có con đẹp quá kìa	bướm nhiều có con đẹp quá
tệ đến thế kia à	tệ thế
ở đây lúc này , trời nóng quá	ở đây lúc này nóng quá
ở đây lúc này , trời sắp mưa	ở đây lúc này mưa sắp
số tác_giả này nhận_định khác hẳn	tác_giả này nhận_định khác hẳn
đã bảo mà	bảo đã
	
một cái tát rất kêu	một tát rất kêu
tiếng đấm , tiếng đá nhau bình_bịch	đấm đá tiếng bình_bịch
họ đã bảo mà	họ bảo đã
phen này thì_phải biết	phen này thì_phải biết
lúc ấy có_thể nghe thấy một cái tác rất kêu	lúc ấy tát nghe
lúc ấy có_thể nghe thấy tiếng đấm_đá nhau bình_bịch	lúc ấy có_thể đấm_đá nghe bình_bịch
đấm_đá như_thế cứ gọi_là tan xương	đấm_đá như_thế tan xương
đại_bác ùng_oàng suốt đêm	đại_bác ùng_oàng suốt đêm
tiếng ùng_oàng của đại_bác nghe thưa dần	tiếng đại_bác ùng_oàng nghe thưa dần
có_tiếng đại_bác nổ ùng_oàng từ xa	xa có_tiếng đại_bác ùng_oàng
điều ấy tôi biết rồi	điều ấy tôi biết rồi
điều anh vừa nói ấy tôi biết rồi	điều anh vừa nói tôi biết
tôi đã xem trận ấy	tôi trận ấy đã xem
tôi đã xem đội ta đấu với đội bạn	tôi xem đội ta đội bạn đấu
vì lợi_ích chung ông_ta đã xin từ_chức	vì lợi_ích chung ông_ta từ_chức xin
Cụ Tú đã bạc hết cả tóc rồi	Cụ Tú tóc bạc hết
Cụ Tú tóc bạc hết cả rồi	Cụ Tú tóc bạc hết
ôi , cảnh ly_biệt mà_sao buồn vậy	ly_biệt mà_sao buồn
anh Đức này , anh lấy tôi làm vợ nhé	anh Đức anh tôi lấy làm vợ
ông Chưởng , phó của cha tôi , nay đã lên tướng	ông Chưởng phó cha tôi nay lên tướng
anh có biết ông ấy không , ông Văn ấy mà	anh ông ấy biết Văn
không ai nói_gì , mọi người lảng dần ra	ai nói_gì không mọi người lảng dần
không ai nói_gì , rồi mọi người lảng dần ra	ai nói_gì không mọi người lảng dần
không ai nói_gì nhưng mọi người lảng dần ra	ai nói_gì không nhưng mọi người lảng dần
không ai nói_gì nên mọi người lảng dần ra	ai nói_gì không nên mọi người lảng dần
tuy không ai nói_gì nhưng mọi người lãng dần ra	tuy ai nói_gì không nhưng mọi người lãng dần
vì không ai nói_gì nên mọi người lãng dần	vì ai nói_gì không nên mọi người lãng dần
đã bấy_lâu_nay bác tới nhà	đã bấy_lâu_nay bác tới nhà
trẻ thời đi vắng , chợ thời xa	trẻ thời đi vắng chợ thời xa
ao sâu nước cả , khôn chài cá	ao nước sâu khôn chài cá
vườn rộng rào thưa , khó duổi gà	vườn rộng rào thưa gà khó duổi
cải chửa ra cây , cà mới nụ	cải cây chửa ra cà nụ mới
bầu vừa rụng rốn , mướp ra hoa	bầu rốn rụng mướp hoa ra
đầu_trò tiếp khách trầu_không có	đầu_trò khách tiếp trầu_không có
bác đến chơi đây , ta với ta	bác đến chơi đây ta với ta
tôi cũng không biết	tôi không biết cũng
sao anh lại nói thế	anh nói sao
chuyện này nghiêm_trọng đây	chuyện này nghiêm_trọng
nhưng ai biết mà sợ	biết ai mà sợ
sau đây là vài điểm cần nói rõ thêm	sau đây vài điểm nói rõ cần
tôi không dính vào việc này	tôi dính không vào
anh cũng đừng nghi_ngờ gì anh_ấy	anh nghi_ngờ đừng anh_ấy
đừng ra sân , ngoài ấy rét lắm	sân ra đừng ngoài ấy rét
bà ấy đánh con chó dữ quá , làm như_thế không có tác_dụng giáo_dục	bà ấy chó đánh quá như_thế tác_dụng không có
tôi không muốn đi , vả_lại đã muộn rồi	tôi đi không muốn vả_lại muộn rồi
	
cám_ơn bác	
cháu cám_ơn bác	
cháu cám_ơn bác ạ	
cuốn Chí_Phèo ở dưới chồng tạp_chí	cuốn Chí_Phèo ở dưới tạp_chí
dưới chồng tạp_chí có cuốn Chí_Phèo	dưới tạp_chí có cuốn Chí_Phèo
chồng tạp_chí ở trên cuốn Chí_Phèo	tạp_chí trên cuốn Chí_Phèo
cái xe màu đỏ ấy mới là xe của tôi	xe màu đỏ là xe của tôi
xe của tôi là cái màu đỏ ấy	xe của tôi màu đỏ
ăn nhiều quá thì mới sinh_bệnh chứ	ăn nhiều sinh_bệnh
sinh_bệnh đâu phải tại ăn , mà tại ăn nhiều quá đấy chứ	sinh_bệnh đâu phải tại ăn nhiều
ai chứ nó thì không tin được	nó không tin
gà của ông Tư chết mất hai con	ông Tư gà hai chết
anh_ấy đã giết ông Ba	anh_ấy ông Ba giết
anh_ấy đã lấy tiền ông Ba	ông Ba anh_ấy lấy tiền
tôi không tiêu tiền_của ông Ba	tôi ông Ba tiêu tiền_của không
nó phải giải nhiều bài	nó nhiều bài phải giải
nó giải được năm bài , thì ba bài đúng	nó bài năm ba đúng
còn hai bài kia thì sai	còn hai sai
